,n,L,total_attempts,total_successes,total_collisions,collision_rate,success_rate,throughput,per_node
0,20,1,6446,3471,2975,0.4615265280794291,0.5384734719205709,0.3471,"[{'tx': 258, 'success': 132, 'collisions': 126}, {'tx': 356, 'success': 202, 'collisions': 154}, {'tx': 316, 'success': 167, 'collisions': 149}, {'tx': 313, 'success': 157, 'collisions': 156}, {'tx': 429, 'success': 241, 'collisions': 188}, {'tx': 409, 'success': 226, 'collisions': 183}, {'tx': 411, 'success': 227, 'collisions': 184}, {'tx': 389, 'success': 211, 'collisions': 178}, {'tx': 321, 'success': 169, 'collisions': 152}, {'tx': 331, 'success': 183, 'collisions': 148}, {'tx': 189, 'success': 97, 'collisions': 92}, {'tx': 233, 'success': 128, 'collisions': 105}, {'tx': 318, 'success': 165, 'collisions': 153}, {'tx': 346, 'success': 178, 'collisions': 168}, {'tx': 308, 'success': 165, 'collisions': 143}, {'tx': 231, 'success': 123, 'collisions': 108}, {'tx': 161, 'success': 76, 'collisions': 85}, {'tx': 273, 'success': 150, 'collisions': 123}, {'tx': 517, 'success': 290, 'collisions': 227}, {'tx': 337, 'success': 184, 'collisions': 153}]"
1,20,2,4329,2329,2000,0.462000462000462,0.537999537999538,0.4658,"[{'tx': 156, 'success': 88, 'collisions': 68}, {'tx': 178, 'success': 94, 'collisions': 84}, {'tx': 244, 'success': 126, 'collisions': 118}, {'tx': 270, 'success': 145, 'collisions': 125}, {'tx': 153, 'success': 82, 'collisions': 71}, {'tx': 130, 'success': 63, 'collisions': 67}, {'tx': 296, 'success': 154, 'collisions': 142}, {'tx': 323, 'success': 175, 'collisions': 148}, {'tx': 215, 'success': 121, 'collisions': 94}, {'tx': 176, 'success': 97, 'collisions': 79}, {'tx': 60, 'success': 26, 'collisions': 34}, {'tx': 233, 'success': 127, 'collisions': 106}, {'tx': 71, 'success': 38, 'collisions': 33}, {'tx': 285, 'success': 164, 'collisions': 121}, {'tx': 385, 'success': 224, 'collisions': 161}, {'tx': 275, 'success': 138, 'collisions': 137}, {'tx': 114, 'success': 50, 'collisions': 64}, {'tx': 298, 'success': 163, 'collisions': 135}, {'tx': 249, 'success': 127, 'collisions': 122}, {'tx': 218, 'success': 127, 'collisions': 91}]"
2,20,3,3398,1747,1651,0.4858740435550324,0.5141259564449676,0.5241,"[{'tx': 246, 'success': 140, 'collisions': 106}, {'tx': 208, 'success': 106, 'collisions': 102}, {'tx': 79, 'success': 36, 'collisions': 43}, {'tx': 240, 'success': 127, 'collisions': 113}, {'tx': 198, 'success': 114, 'collisions': 84}, {'tx': 115, 'success': 53, 'collisions': 62}, {'tx': 225, 'success': 112, 'collisions': 113}, {'tx': 111, 'success': 54, 'collisions': 57}, {'tx': 38, 'success': 12, 'collisions': 26}, {'tx': 146, 'success': 75, 'collisions': 71}, {'tx': 156, 'success': 82, 'collisions': 74}, {'tx': 99, 'success': 42, 'collisions': 57}, {'tx': 242, 'success': 133, 'collisions': 109}, {'tx': 244, 'success': 129, 'collisions': 115}, {'tx': 107, 'success': 52, 'collisions': 55}, {'tx': 212, 'success': 102, 'collisions': 110}, {'tx': 207, 'success': 104, 'collisions': 103}, {'tx': 191, 'success': 100, 'collisions': 91}, {'tx': 235, 'success': 125, 'collisions': 110}, {'tx': 99, 'success': 49, 'collisions': 50}]"
3,20,4,2772,1426,1346,0.4855699855699856,0.5144300144300145,0.5704,"[{'tx': 214, 'success': 117, 'collisions': 97}, {'tx': 245, 'success': 143, 'collisions': 102}, {'tx': 214, 'success': 115, 'collisions': 99}, {'tx': 123, 'success': 61, 'collisions': 62}, {'tx': 70, 'success': 27, 'collisions': 43}, {'tx': 150, 'success': 86, 'collisions': 64}, {'tx': 177, 'success': 97, 'collisions': 80}, {'tx': 139, 'success': 67, 'collisions': 72}, {'tx': 137, 'success': 70, 'collisions': 67}, {'tx': 58, 'success': 26, 'collisions': 32}, {'tx': 126, 'success': 68, 'collisions': 58}, {'tx': 162, 'success': 82, 'collisions': 80}, {'tx': 184, 'success': 100, 'collisions': 84}, {'tx': 180, 'success': 91, 'collisions': 89}, {'tx': 180, 'success': 92, 'collisions': 88}, {'tx': 147, 'success': 76, 'collisions': 71}, {'tx': 66, 'success': 26, 'collisions': 40}, {'tx': 41, 'success': 13, 'collisions': 28}, {'tx': 52, 'success': 22, 'collisions': 30}, {'tx': 107, 'success': 47, 'collisions': 60}]"
4,20,5,2291,1154,1137,0.49628982976866,0.50371017023134,0.577,"[{'tx': 133, 'success': 65, 'collisions': 68}, {'tx': 143, 'success': 73, 'collisions': 70}, {'tx': 165, 'success': 89, 'collisions': 76}, {'tx': 82, 'success': 40, 'collisions': 42}, {'tx': 171, 'success': 94, 'collisions': 77}, {'tx': 11, 'success': 2, 'collisions': 9}, {'tx': 100, 'success': 52, 'collisions': 48}, {'tx': 166, 'success': 88, 'collisions': 78}, {'tx': 166, 'success': 83, 'collisions': 83}, {'tx': 114, 'success': 63, 'collisions': 51}, {'tx': 168, 'success': 91, 'collisions': 77}, {'tx': 174, 'success': 92, 'collisions': 82}, {'tx': 63, 'success': 32, 'collisions': 31}, {'tx': 93, 'success': 41, 'collisions': 52}, {'tx': 113, 'success': 53, 'collisions': 60}, {'tx': 41, 'success': 16, 'collisions': 25}, {'tx': 48, 'success': 18, 'collisions': 30}, {'tx': 91, 'success': 41, 'collisions': 50}, {'tx': 71, 'success': 35, 'collisions': 36}, {'tx': 178, 'success': 86, 'collisions': 92}]"
5,20,6,1941,994,947,0.487892838742916,0.512107161257084,0.5964,"[{'tx': 14, 'success': 2, 'collisions': 12}, {'tx': 128, 'success': 66, 'collisions': 62}, {'tx': 142, 'success': 74, 'collisions': 68}, {'tx': 15, 'success': 4, 'collisions': 11}, {'tx': 147, 'success': 76, 'collisions': 71}, {'tx': 30, 'success': 16, 'collisions': 14}, {'tx': 122, 'success': 74, 'collisions': 48}, {'tx': 21, 'success': 7, 'collisions': 14}, {'tx': 159, 'success': 91, 'collisions': 68}, {'tx': 80, 'success': 38, 'collisions': 42}, {'tx': 91, 'success': 44, 'collisions': 47}, {'tx': 112, 'success': 57, 'collisions': 55}, {'tx': 42, 'success': 12, 'collisions': 30}, {'tx': 167, 'success': 90, 'collisions': 77}, {'tx': 163, 'success': 85, 'collisions': 78}, {'tx': 66, 'success': 27, 'collisions': 39}, {'tx': 134, 'success': 75, 'collisions': 59}, {'tx': 174, 'success': 99, 'collisions': 75}, {'tx': 117, 'success': 53, 'collisions': 64}, {'tx': 17, 'success': 4, 'collisions': 13}]"
6,20,7,1734,878,856,0.4936562860438293,0.5063437139561707,0.6146,"[{'tx': 56, 'success': 23, 'collisions': 33}, {'tx': 118, 'success': 64, 'collisions': 54}, {'tx': 147, 'success': 78, 'collisions': 69}, {'tx': 107, 'success': 55, 'collisions': 52}, {'tx': 86, 'success': 48, 'collisions': 38}, {'tx': 106, 'success': 52, 'collisions': 54}, {'tx': 42, 'success': 17, 'collisions': 25}, {'tx': 94, 'success': 52, 'collisions': 42}, {'tx': 17, 'success': 4, 'collisions': 13}, {'tx': 123, 'success': 77, 'collisions': 46}, {'tx': 107, 'success': 57, 'collisions': 50}, {'tx': 83, 'success': 43, 'collisions': 40}, {'tx': 126, 'success': 67, 'collisions': 59}, {'tx': 30, 'success': 8, 'collisions': 22}, {'tx': 96, 'success': 48, 'collisions': 48}, {'tx': 44, 'success': 16, 'collisions': 28}, {'tx': 91, 'success': 43, 'collisions': 48}, {'tx': 68, 'success': 31, 'collisions': 37}, {'tx': 71, 'success': 31, 'collisions': 40}, {'tx': 122, 'success': 64, 'collisions': 58}]"
7,20,8,1533,790,743,0.4846705805609915,0.5153294194390085,0.632,"[{'tx': 85, 'success': 41, 'collisions': 44}, {'tx': 110, 'success': 62, 'collisions': 48}, {'tx': 24, 'success': 5, 'collisions': 19}, {'tx': 82, 'success': 41, 'collisions': 41}, {'tx': 8, 'success': 1, 'collisions': 7}, {'tx': 86, 'success': 43, 'collisions': 43}, {'tx': 77, 'success': 41, 'collisions': 36}, {'tx': 117, 'success': 62, 'collisions': 55}, {'tx': 137, 'success': 89, 'collisions': 48}, {'tx': 67, 'success': 36, 'collisions': 31}, {'tx': 56, 'success': 27, 'collisions': 29}, {'tx': 93, 'success': 46, 'collisions': 47}, {'tx': 68, 'success': 39, 'collisions': 29}, {'tx': 54, 'success': 28, 'collisions': 26}, {'tx': 74, 'success': 40, 'collisions': 34}, {'tx': 68, 'success': 27, 'collisions': 41}, {'tx': 137, 'success': 75, 'collisions': 62}, {'tx': 77, 'success': 39, 'collisions': 38}, {'tx': 69, 'success': 32, 'collisions': 37}, {'tx': 44, 'success': 16, 'collisions': 28}]"
8,20,9,1413,698,715,0.5060155697098372,0.49398443029016276,0.6282,"[{'tx': 59, 'success': 28, 'collisions': 31}, {'tx': 95, 'success': 50, 'collisions': 45}, {'tx': 40, 'success': 22, 'collisions': 18}, {'tx': 48, 'success': 19, 'collisions': 29}, {'tx': 38, 'success': 15, 'collisions': 23}, {'tx': 111, 'success': 62, 'collisions': 49}, {'tx': 70, 'success': 38, 'collisions': 32}, {'tx': 27, 'success': 10, 'collisions': 17}, {'tx': 56, 'success': 32, 'collisions': 24}, {'tx': 62, 'success': 30, 'collisions': 32}, {'tx': 75, 'success': 37, 'collisions': 38}, {'tx': 43, 'success': 17, 'collisions': 26}, {'tx': 39, 'success': 15, 'collisions': 24}, {'tx': 66, 'success': 32, 'collisions': 34}, {'tx': 103, 'success': 50, 'collisions': 53}, {'tx': 111, 'success': 55, 'collisions': 56}, {'tx': 111, 'success': 59, 'collisions': 52}, {'tx': 77, 'success': 40, 'collisions': 37}, {'tx': 100, 'success': 50, 'collisions': 50}, {'tx': 82, 'success': 37, 'collisions': 45}]"
9,20,10,1270,637,633,0.4984251968503937,0.5015748031496063,0.637,"[{'tx': 26, 'success': 7, 'collisions': 19}, {'tx': 21, 'success': 7, 'collisions': 14}, {'tx': 95, 'success': 52, 'collisions': 43}, {'tx': 102, 'success': 54, 'collisions': 48}, {'tx': 87, 'success': 50, 'collisions': 37}, {'tx': 20, 'success': 4, 'collisions': 16}, {'tx': 98, 'success': 59, 'collisions': 39}, {'tx': 102, 'success': 53, 'collisions': 49}, {'tx': 55, 'success': 25, 'collisions': 30}, {'tx': 36, 'success': 11, 'collisions': 25}, {'tx': 83, 'success': 48, 'collisions': 35}, {'tx': 21, 'success': 7, 'collisions': 14}, {'tx': 57, 'success': 24, 'collisions': 33}, {'tx': 61, 'success': 29, 'collisions': 32}, {'tx': 59, 'success': 28, 'collisions': 31}, {'tx': 111, 'success': 60, 'collisions': 51}, {'tx': 93, 'success': 46, 'collisions': 47}, {'tx': 74, 'success': 42, 'collisions': 32}, {'tx': 14, 'success': 2, 'collisions': 12}, {'tx': 55, 'success': 29, 'collisions': 26}]"
10,20,11,1184,568,616,0.5202702702702703,0.4797297297297297,0.6248,"[{'tx': 66, 'success': 34, 'collisions': 32}, {'tx': 101, 'success': 50, 'collisions': 51}, {'tx': 42, 'success': 15, 'collisions': 27}, {'tx': 48, 'success': 23, 'collisions': 25}, {'tx': 36, 'success': 16, 'collisions': 20}, {'tx': 86, 'success': 46, 'collisions': 40}, {'tx': 44, 'success': 17, 'collisions': 27}, {'tx': 46, 'success': 23, 'collisions': 23}, {'tx': 78, 'success': 31, 'collisions': 47}, {'tx': 8, 'success': 1, 'collisions': 7}, {'tx': 57, 'success': 30, 'collisions': 27}, {'tx': 76, 'success': 41, 'collisions': 35}, {'tx': 55, 'success': 29, 'collisions': 26}, {'tx': 41, 'success': 13, 'collisions': 28}, {'tx': 84, 'success': 45, 'collisions': 39}, {'tx': 19, 'success': 8, 'collisions': 11}, {'tx': 95, 'success': 48, 'collisions': 47}, {'tx': 78, 'success': 39, 'collisions': 39}, {'tx': 57, 'success': 27, 'collisions': 30}, {'tx': 67, 'success': 32, 'collisions': 35}]"
11,20,12,1085,519,566,0.5216589861751152,0.4783410138248848,0.6228,"[{'tx': 75, 'success': 33, 'collisions': 42}, {'tx': 67, 'success': 33, 'collisions': 34}, {'tx': 83, 'success': 45, 'collisions': 38}, {'tx': 56, 'success': 27, 'collisions': 29}, {'tx': 73, 'success': 35, 'collisions': 38}, {'tx': 54, 'success': 28, 'collisions': 26}, {'tx': 48, 'success': 26, 'collisions': 22}, {'tx': 60, 'success': 29, 'collisions': 31}, {'tx': 86, 'success': 49, 'collisions': 37}, {'tx': 22, 'success': 7, 'collisions': 15}, {'tx': 92, 'success': 52, 'collisions': 40}, {'tx': 52, 'success': 23, 'collisions': 29}, {'tx': 23, 'success': 5, 'collisions': 18}, {'tx': 47, 'success': 19, 'collisions': 28}, {'tx': 11, 'success': 2, 'collisions': 9}, {'tx': 27, 'success': 6, 'collisions': 21}, {'tx': 85, 'success': 51, 'collisions': 34}, {'tx': 20, 'success': 4, 'collisions': 16}, {'tx': 53, 'success': 22, 'collisions': 31}, {'tx': 51, 'success': 23, 'collisions': 28}]"
12,20,13,1000,506,494,0.494,0.506,0.6578,"[{'tx': 49, 'success': 22, 'collisions': 27}, {'tx': 55, 'success': 31, 'collisions': 24}, {'tx': 38, 'success': 17, 'collisions': 21}, {'tx': 8, 'success': 1, 'collisions': 7}, {'tx': 26, 'success': 10, 'collisions': 16}, {'tx': 66, 'success': 41, 'collisions': 25}, {'tx': 55, 'success': 30, 'collisions': 25}, {'tx': 63, 'success': 35, 'collisions': 28}, {'tx': 88, 'success': 45, 'collisions': 43}, {'tx': 44, 'success': 16, 'collisions': 28}, {'tx': 73, 'success': 43, 'collisions': 30}, {'tx': 23, 'success': 8, 'collisions': 15}, {'tx': 54, 'success': 29, 'collisions': 25}, {'tx': 33, 'success': 12, 'collisions': 21}, {'tx': 76, 'success': 43, 'collisions': 33}, {'tx': 36, 'success': 16, 'collisions': 20}, {'tx': 26, 'success': 9, 'collisions': 17}, {'tx': 63, 'success': 32, 'collisions': 31}, {'tx': 55, 'success': 29, 'collisions': 26}, {'tx': 69, 'success': 37, 'collisions': 32}]"
13,20,14,937,456,481,0.5133404482390609,0.48665955176093917,0.6384,"[{'tx': 38, 'success': 16, 'collisions': 22}, {'tx': 53, 'success': 29, 'collisions': 24}, {'tx': 21, 'success': 8, 'collisions': 13}, {'tx': 63, 'success': 33, 'collisions': 30}, {'tx': 51, 'success': 27, 'collisions': 24}, {'tx': 37, 'success': 16, 'collisions': 21}, {'tx': 63, 'success': 31, 'collisions': 32}, {'tx': 23, 'success': 9, 'collisions': 14}, {'tx': 89, 'success': 50, 'collisions': 39}, {'tx': 74, 'success': 34, 'collisions': 40}, {'tx': 36, 'success': 15, 'collisions': 21}, {'tx': 35, 'success': 15, 'collisions': 20}, {'tx': 17, 'success': 4, 'collisions': 13}, {'tx': 64, 'success': 36, 'collisions': 28}, {'tx': 11, 'success': 1, 'collisions': 10}, {'tx': 63, 'success': 34, 'collisions': 29}, {'tx': 52, 'success': 21, 'collisions': 31}, {'tx': 44, 'success': 19, 'collisions': 25}, {'tx': 6, 'success': 0, 'collisions': 6}, {'tx': 97, 'success': 58, 'collisions': 39}]"
14,20,15,896,419,477,0.5323660714285714,0.46763392857142855,0.6285,"[{'tx': 9, 'success': 1, 'collisions': 8}, {'tx': 56, 'success': 27, 'collisions': 29}, {'tx': 55, 'success': 29, 'collisions': 26}, {'tx': 61, 'success': 35, 'collisions': 26}, {'tx': 7, 'success': 0, 'collisions': 7}, {'tx': 70, 'success': 41, 'collisions': 29}, {'tx': 53, 'success': 22, 'collisions': 31}, {'tx': 44, 'success': 21, 'collisions': 23}, {'tx': 53, 'success': 25, 'collisions': 28}, {'tx': 68, 'success': 35, 'collisions': 33}, {'tx': 56, 'success': 25, 'collisions': 31}, {'tx': 24, 'success': 10, 'collisions': 14}, {'tx': 70, 'success': 31, 'collisions': 39}, {'tx': 22, 'success': 9, 'collisions': 13}, {'tx': 20, 'success': 8, 'collisions': 12}, {'tx': 38, 'success': 17, 'collisions': 21}, {'tx': 72, 'success': 40, 'collisions': 32}, {'tx': 44, 'success': 17, 'collisions': 27}, {'tx': 37, 'success': 12, 'collisions': 25}, {'tx': 37, 'success': 14, 'collisions': 23}]"
15,20,16,813,412,401,0.4932349323493235,0.5067650676506765,0.6592,"[{'tx': 29, 'success': 13, 'collisions': 16}, {'tx': 6, 'success': 0, 'collisions': 6}, {'tx': 87, 'success': 49, 'collisions': 38}, {'tx': 6, 'success': 0, 'collisions': 6}, {'tx': 54, 'success': 26, 'collisions': 28}, {'tx': 23, 'success': 8, 'collisions': 15}, {'tx': 42, 'success': 21, 'collisions': 21}, {'tx': 52, 'success': 32, 'collisions': 20}, {'tx': 26, 'success': 10, 'collisions': 16}, {'tx': 56, 'success': 29, 'collisions': 27}, {'tx': 52, 'success': 29, 'collisions': 23}, {'tx': 37, 'success': 17, 'collisions': 20}, {'tx': 48, 'success': 26, 'collisions': 22}, {'tx': 55, 'success': 33, 'collisions': 22}, {'tx': 49, 'success': 29, 'collisions': 20}, {'tx': 16, 'success': 4, 'collisions': 12}, {'tx': 50, 'success': 25, 'collisions': 25}, {'tx': 51, 'success': 29, 'collisions': 22}, {'tx': 42, 'success': 19, 'collisions': 23}, {'tx': 32, 'success': 13, 'collisions': 19}]"
16,20,17,792,384,408,0.5151515151515151,0.48484848484848486,0.6528,"[{'tx': 35, 'success': 14, 'collisions': 21}, {'tx': 82, 'success': 50, 'collisions': 32}, {'tx': 27, 'success': 12, 'collisions': 15}, {'tx': 40, 'success': 19, 'collisions': 21}, {'tx': 41, 'success': 20, 'collisions': 21}, {'tx': 11, 'success': 2, 'collisions': 9}, {'tx': 44, 'success': 22, 'collisions': 22}, {'tx': 35, 'success': 15, 'collisions': 20}, {'tx': 54, 'success': 25, 'collisions': 29}, {'tx': 25, 'success': 11, 'collisions': 14}, {'tx': 21, 'success': 6, 'collisions': 15}, {'tx': 56, 'success': 29, 'collisions': 27}, {'tx': 73, 'success': 42, 'collisions': 31}, {'tx': 42, 'success': 18, 'collisions': 24}, {'tx': 58, 'success': 31, 'collisions': 27}, {'tx': 7, 'success': 0, 'collisions': 7}, {'tx': 21, 'success': 6, 'collisions': 15}, {'tx': 35, 'success': 17, 'collisions': 18}, {'tx': 42, 'success': 21, 'collisions': 21}, {'tx': 43, 'success': 24, 'collisions': 19}]"
17,20,18,735,359,376,0.5115646258503401,0.4884353741496599,0.6462,"[{'tx': 8, 'success': 1, 'collisions': 7}, {'tx': 54, 'success': 30, 'collisions': 24}, {'tx': 22, 'success': 10, 'collisions': 12}, {'tx': 14, 'success': 6, 'collisions': 8}, {'tx': 65, 'success': 39, 'collisions': 26}, {'tx': 52, 'success': 32, 'collisions': 20}, {'tx': 24, 'success': 6, 'collisions': 18}, {'tx': 62, 'success': 35, 'collisions': 27}, {'tx': 40, 'success': 18, 'collisions': 22}, {'tx': 26, 'success': 8, 'collisions': 18}, {'tx': 28, 'success': 12, 'collisions': 16}, {'tx': 30, 'success': 15, 'collisions': 15}, {'tx': 54, 'success': 28, 'collisions': 26}, {'tx': 72, 'success': 41, 'collisions': 31}, {'tx': 16, 'success': 6, 'collisions': 10}, {'tx': 20, 'success': 8, 'collisions': 12}, {'tx': 43, 'success': 16, 'collisions': 27}, {'tx': 12, 'success': 3, 'collisions': 9}, {'tx': 50, 'success': 26, 'collisions': 24}, {'tx': 43, 'success': 19, 'collisions': 24}]"
18,20,19,719,330,389,0.541029207232267,0.45897079276773295,0.627,"[{'tx': 19, 'success': 7, 'collisions': 12}, {'tx': 41, 'success': 19, 'collisions': 22}, {'tx': 36, 'success': 13, 'collisions': 23}, {'tx': 45, 'success': 24, 'collisions': 21}, {'tx': 46, 'success': 23, 'collisions': 23}, {'tx': 39, 'success': 16, 'collisions': 23}, {'tx': 9, 'success': 1, 'collisions': 8}, {'tx': 14, 'success': 4, 'collisions': 10}, {'tx': 59, 'success': 27, 'collisions': 32}, {'tx': 40, 'success': 16, 'collisions': 24}, {'tx': 36, 'success': 18, 'collisions': 18}, {'tx': 39, 'success': 19, 'collisions': 20}, {'tx': 42, 'success': 22, 'collisions': 20}, {'tx': 54, 'success': 30, 'collisions': 24}, {'tx': 29, 'success': 14, 'collisions': 15}, {'tx': 8, 'success': 1, 'collisions': 7}, {'tx': 42, 'success': 22, 'collisions': 20}, {'tx': 48, 'success': 23, 'collisions': 25}, {'tx': 41, 'success': 18, 'collisions': 23}, {'tx': 32, 'success': 13, 'collisions': 19}]"
19,20,20,677,322,355,0.5243722304283605,0.4756277695716396,0.644,"[{'tx': 20, 'success': 11, 'collisions': 9}, {'tx': 23, 'success': 9, 'collisions': 14}, {'tx': 30, 'success': 12, 'collisions': 18}, {'tx': 60, 'success': 34, 'collisions': 26}, {'tx': 13, 'success': 3, 'collisions': 10}, {'tx': 6, 'success': 0, 'collisions': 6}, {'tx': 50, 'success': 25, 'collisions': 25}, {'tx': 57, 'success': 31, 'collisions': 26}, {'tx': 52, 'success': 29, 'collisions': 23}, {'tx': 46, 'success': 29, 'collisions': 17}, {'tx': 19, 'success': 7, 'collisions': 12}, {'tx': 21, 'success': 6, 'collisions': 15}, {'tx': 35, 'success': 17, 'collisions': 18}, {'tx': 45, 'success': 19, 'collisions': 26}, {'tx': 33, 'success': 10, 'collisions': 23}, {'tx': 19, 'success': 7, 'collisions': 12}, {'tx': 22, 'success': 8, 'collisions': 14}, {'tx': 41, 'success': 20, 'collisions': 21}, {'tx': 49, 'success': 27, 'collisions': 22}, {'tx': 36, 'success': 18, 'collisions': 18}]"
20,20,21,653,326,327,0.5007656967840735,0.4992343032159265,0.6846,"[{'tx': 39, 'success': 23, 'collisions': 16}, {'tx': 27, 'success': 12, 'collisions': 15}, {'tx': 27, 'success': 10, 'collisions': 17}, {'tx': 36, 'success': 20, 'collisions': 16}, {'tx': 45, 'success': 22, 'collisions': 23}, {'tx': 66, 'success': 44, 'collisions': 22}, {'tx': 22, 'success': 9, 'collisions': 13}, {'tx': 39, 'success': 24, 'collisions': 15}, {'tx': 43, 'success': 28, 'collisions': 15}, {'tx': 23, 'success': 8, 'collisions': 15}, {'tx': 54, 'success': 27, 'collisions': 27}, {'tx': 17, 'success': 5, 'collisions': 12}, {'tx': 6, 'success': 0, 'collisions': 6}, {'tx': 54, 'success': 31, 'collisions': 23}, {'tx': 16, 'success': 6, 'collisions': 10}, {'tx': 14, 'success': 3, 'collisions': 11}, {'tx': 41, 'success': 18, 'collisions': 23}, {'tx': 37, 'success': 14, 'collisions': 23}, {'tx': 6, 'success': 0, 'collisions': 6}, {'tx': 41, 'success': 22, 'collisions': 19}]"
21,20,22,625,297,328,0.5248,0.4752,0.6534,"[{'tx': 22, 'success': 6, 'collisions': 16}, {'tx': 61, 'success': 34, 'collisions': 27}, {'tx': 16, 'success': 5, 'collisions': 11}, {'tx': 15, 'success': 5, 'collisions': 10}, {'tx': 45, 'success': 22, 'collisions': 23}, {'tx': 36, 'success': 20, 'collisions': 16}, {'tx': 50, 'success': 26, 'collisions': 24}, {'tx': 49, 'success': 26, 'collisions': 23}, {'tx': 22, 'success': 7, 'collisions': 15}, {'tx': 28, 'success': 12, 'collisions': 16}, {'tx': 6, 'success': 0, 'collisions': 6}, {'tx': 51, 'success': 27, 'collisions': 24}, {'tx': 16, 'success': 5, 'collisions': 11}, {'tx': 27, 'success': 14, 'collisions': 13}, {'tx': 34, 'success': 19, 'collisions': 15}, {'tx': 23, 'success': 10, 'collisions': 13}, {'tx': 20, 'success': 7, 'collisions': 13}, {'tx': 29, 'success': 12, 'collisions': 17}, {'tx': 34, 'success': 18, 'collisions': 16}, {'tx': 41, 'success': 22, 'collisions': 19}]"
22,20,23,591,287,304,0.5143824027072758,0.4856175972927242,0.6601,"[{'tx': 18, 'success': 7, 'collisions': 11}, {'tx': 8, 'success': 2, 'collisions': 6}, {'tx': 30, 'success': 9, 'collisions': 21}, {'tx': 39, 'success': 23, 'collisions': 16}, {'tx': 43, 'success': 20, 'collisions': 23}, {'tx': 29, 'success': 13, 'collisions': 16}, {'tx': 44, 'success': 23, 'collisions': 21}, {'tx': 30, 'success': 12, 'collisions': 18}, {'tx': 25, 'success': 11, 'collisions': 14}, {'tx': 6, 'success': 0, 'collisions': 6}, {'tx': 21, 'success': 10, 'collisions': 11}, {'tx': 52, 'success': 29, 'collisions': 23}, {'tx': 22, 'success': 8, 'collisions': 14}, {'tx': 10, 'success': 2, 'collisions': 8}, {'tx': 30, 'success': 14, 'collisions': 16}, {'tx': 57, 'success': 38, 'collisions': 19}, {'tx': 5, 'success': 0, 'collisions': 5}, {'tx': 44, 'success': 25, 'collisions': 19}, {'tx': 43, 'success': 22, 'collisions': 21}, {'tx': 35, 'success': 19, 'collisions': 16}]"
23,20,24,573,269,304,0.5305410122164049,0.4694589877835951,0.6456,"[{'tx': 44, 'success': 22, 'collisions': 22}, {'tx': 38, 'success': 18, 'collisions': 20}, {'tx': 39, 'success': 21, 'collisions': 18}, {'tx': 8, 'success': 1, 'collisions': 7}, {'tx': 38, 'success': 20, 'collisions': 18}, {'tx': 24, 'success': 9, 'collisions': 15}, {'tx': 28, 'success': 14, 'collisions': 14}, {'tx': 13, 'success': 4, 'collisions': 9}, {'tx': 28, 'success': 14, 'collisions': 14}, {'tx': 38, 'success': 19, 'collisions': 19}, {'tx': 13, 'success': 3, 'collisions': 10}, {'tx': 55, 'success': 34, 'collisions': 21}, {'tx': 33, 'success': 14, 'collisions': 19}, {'tx': 40, 'success': 20, 'collisions': 20}, {'tx': 27, 'success': 10, 'collisions': 17}, {'tx': 31, 'success': 14, 'collisions': 17}, {'tx': 6, 'success': 0, 'collisions': 6}, {'tx': 12, 'success': 2, 'collisions': 10}, {'tx': 38, 'success': 24, 'collisions': 14}, {'tx': 20, 'success': 6, 'collisions': 14}]"
24,20,25,547,260,287,0.5246800731261426,0.4753199268738574,0.65,"[{'tx': 23, 'success': 8, 'collisions': 15}, {'tx': 28, 'success': 12, 'collisions': 16}, {'tx': 39, 'success': 19, 'collisions': 20}, {'tx': 48, 'success': 27, 'collisions': 21}, {'tx': 47, 'success': 27, 'collisions': 20}, {'tx': 26, 'success': 11, 'collisions': 15}, {'tx': 5, 'success': 0, 'collisions': 5}, {'tx': 14, 'success': 6, 'collisions': 8}, {'tx': 22, 'success': 7, 'collisions': 15}, {'tx': 42, 'success': 27, 'collisions': 15}, {'tx': 35, 'success': 16, 'collisions': 19}, {'tx': 16, 'success': 5, 'collisions': 11}, {'tx': 26, 'success': 13, 'collisions': 13}, {'tx': 41, 'success': 20, 'collisions': 21}, {'tx': 6, 'success': 0, 'collisions': 6}, {'tx': 30, 'success': 13, 'collisions': 17}, {'tx': 33, 'success': 15, 'collisions': 18}, {'tx': 18, 'success': 8, 'collisions': 10}, {'tx': 29, 'success': 17, 'collisions': 12}, {'tx': 19, 'success': 9, 'collisions': 10}]"
25,20,26,528,253,275,0.5208333333333334,0.4791666666666667,0.6578,"[{'tx': 35, 'success': 21, 'collisions': 14}, {'tx': 47, 'success': 27, 'collisions': 20}, {'tx': 28, 'success': 14, 'collisions': 14}, {'tx': 45, 'success': 26, 'collisions': 19}, {'tx': 35, 'success': 17, 'collisions': 18}, {'tx': 13, 'success': 3, 'collisions': 10}, {'tx': 18, 'success': 8, 'collisions': 10}, {'tx': 26, 'success': 10, 'collisions': 16}, {'tx': 35, 'success': 18, 'collisions': 17}, {'tx': 44, 'success': 27, 'collisions': 17}, {'tx': 18, 'success': 8, 'collisions': 10}, {'tx': 24, 'success': 10, 'collisions': 14}, {'tx': 6, 'success': 0, 'collisions': 6}, {'tx': 24, 'success': 8, 'collisions': 16}, {'tx': 43, 'success': 23, 'collisions': 20}, {'tx': 15, 'success': 4, 'collisions': 11}, {'tx': 20, 'success': 10, 'collisions': 10}, {'tx': 6, 'success': 1, 'collisions': 5}, {'tx': 22, 'success': 11, 'collisions': 11}, {'tx': 24, 'success': 7, 'collisions': 17}]"
26,20,27,510,239,271,0.5313725490196078,0.46862745098039216,0.6453,"[{'tx': 15, 'success': 4, 'collisions': 11}, {'tx': 58, 'success': 36, 'collisions': 22}, {'tx': 17, 'success': 5, 'collisions': 12}, {'tx': 47, 'success': 25, 'collisions': 22}, {'tx': 5, 'success': 0, 'collisions': 5}, {'tx': 37, 'success': 19, 'collisions': 18}, {'tx': 32, 'success': 12, 'collisions': 20}, {'tx': 45, 'success': 23, 'collisions': 22}, {'tx': 6, 'success': 0, 'collisions': 6}, {'tx': 6, 'success': 1, 'collisions': 5}, {'tx': 5, 'success': 0, 'collisions': 5}, {'tx': 9, 'success': 1, 'collisions': 8}, {'tx': 8, 'success': 1, 'collisions': 7}, {'tx': 45, 'success': 27, 'collisions': 18}, {'tx': 30, 'success': 14, 'collisions': 16}, {'tx': 28, 'success': 14, 'collisions': 14}, {'tx': 15, 'success': 5, 'collisions': 10}, {'tx': 51, 'success': 29, 'collisions': 22}, {'tx': 19, 'success': 6, 'collisions': 13}, {'tx': 32, 'success': 17, 'collisions': 15}]"
27,20,28,509,221,288,0.5658153241650294,0.43418467583497056,0.6188,"[{'tx': 29, 'success': 12, 'collisions': 17}, {'tx': 9, 'success': 1, 'collisions': 8}, {'tx': 34, 'success': 15, 'collisions': 19}, {'tx': 43, 'success': 22, 'collisions': 21}, {'tx': 44, 'success': 21, 'collisions': 23}, {'tx': 15, 'success': 3, 'collisions': 12}, {'tx': 43, 'success': 22, 'collisions': 21}, {'tx': 9, 'success': 2, 'collisions': 7}, {'tx': 18, 'success': 6, 'collisions': 12}, {'tx': 30, 'success': 14, 'collisions': 16}, {'tx': 42, 'success': 20, 'collisions': 22}, {'tx': 16, 'success': 5, 'collisions': 11}, {'tx': 5, 'success': 0, 'collisions': 5}, {'tx': 22, 'success': 10, 'collisions': 12}, {'tx': 38, 'success': 18, 'collisions': 20}, {'tx': 27, 'success': 12, 'collisions': 15}, {'tx': 10, 'success': 3, 'collisions': 7}, {'tx': 6, 'success': 0, 'collisions': 6}, {'tx': 25, 'success': 11, 'collisions': 14}, {'tx': 44, 'success': 24, 'collisions': 20}]"
28,20,29,491,213,278,0.5661914460285132,0.43380855397148677,0.6177,"[{'tx': 34, 'success': 17, 'collisions': 17}, {'tx': 17, 'success': 5, 'collisions': 12}, {'tx': 10, 'success': 3, 'collisions': 7}, {'tx': 7, 'success': 1, 'collisions': 6}, {'tx': 19, 'success': 5, 'collisions': 14}, {'tx': 25, 'success': 10, 'collisions': 15}, {'tx': 17, 'success': 4, 'collisions': 13}, {'tx': 18, 'success': 7, 'collisions': 11}, {'tx': 42, 'success': 18, 'collisions': 24}, {'tx': 29, 'success': 14, 'collisions': 15}, {'tx': 38, 'success': 21, 'collisions': 17}, {'tx': 6, 'success': 0, 'collisions': 6}, {'tx': 35, 'success': 16, 'collisions': 19}, {'tx': 20, 'success': 6, 'collisions': 14}, {'tx': 23, 'success': 13, 'collisions': 10}, {'tx': 28, 'success': 15, 'collisions': 13}, {'tx': 26, 'success': 11, 'collisions': 15}, {'tx': 42, 'success': 24, 'collisions': 18}, {'tx': 25, 'success': 11, 'collisions': 14}, {'tx': 30, 'success': 12, 'collisions': 18}]"
29,20,30,474,207,267,0.5632911392405063,0.43670886075949367,0.621,"[{'tx': 31, 'success': 20, 'collisions': 11}, {'tx': 36, 'success': 16, 'collisions': 20}, {'tx': 16, 'success': 3, 'collisions': 13}, {'tx': 12, 'success': 4, 'collisions': 8}, {'tx': 13, 'success': 3, 'collisions': 10}, {'tx': 15, 'success': 4, 'collisions': 11}, {'tx': 22, 'success': 8, 'collisions': 14}, {'tx': 24, 'success': 11, 'collisions': 13}, {'tx': 31, 'success': 15, 'collisions': 16}, {'tx': 19, 'success': 6, 'collisions': 13}, {'tx': 20, 'success': 6, 'collisions': 14}, {'tx': 26, 'success': 14, 'collisions': 12}, {'tx': 25, 'success': 13, 'collisions': 12}, {'tx': 15, 'success': 6, 'collisions': 9}, {'tx': 16, 'success': 5, 'collisions': 11}, {'tx': 35, 'success': 17, 'collisions': 18}, {'tx': 28, 'success': 12, 'collisions': 16}, {'tx': 27, 'success': 9, 'collisions': 18}, {'tx': 34, 'success': 18, 'collisions': 16}, {'tx': 29, 'success': 17, 'collisions': 12}]"
30,20,31,460,200,260,0.5652173913043478,0.43478260869565216,0.62,"[{'tx': 32, 'success': 17, 'collisions': 15}, {'tx': 45, 'success': 29, 'collisions': 16}, {'tx': 16, 'success': 7, 'collisions': 9}, {'tx': 16, 'success': 7, 'collisions': 9}, {'tx': 14, 'success': 4, 'collisions': 10}, {'tx': 29, 'success': 11, 'collisions': 18}, {'tx': 15, 'success': 4, 'collisions': 11}, {'tx': 25, 'success': 10, 'collisions': 15}, {'tx': 18, 'success': 6, 'collisions': 12}, {'tx': 5, 'success': 0, 'collisions': 5}, {'tx': 38, 'success': 20, 'collisions': 18}, {'tx': 35, 'success': 15, 'collisions': 20}, {'tx': 9, 'success': 3, 'collisions': 6}, {'tx': 20, 'success': 8, 'collisions': 12}, {'tx': 37, 'success': 17, 'collisions': 20}, {'tx': 20, 'success': 7, 'collisions': 13}, {'tx': 16, 'success': 4, 'collisions': 12}, {'tx': 19, 'success': 7, 'collisions': 12}, {'tx': 18, 'success': 6, 'collisions': 12}, {'tx': 33, 'success': 18, 'collisions': 15}]"
31,20,32,438,198,240,0.547945205479452,0.4520547945205479,0.6336,"[{'tx': 42, 'success': 25, 'collisions': 17}, {'tx': 6, 'success': 0, 'collisions': 6}, {'tx': 27, 'success': 9, 'collisions': 18}, {'tx': 28, 'success': 13, 'collisions': 15}, {'tx': 21, 'success': 10, 'collisions': 11}, {'tx': 8, 'success': 1, 'collisions': 7}, {'tx': 28, 'success': 13, 'collisions': 15}, {'tx': 21, 'success': 6, 'collisions': 15}, {'tx': 12, 'success': 3, 'collisions': 9}, {'tx': 11, 'success': 4, 'collisions': 7}, {'tx': 24, 'success': 13, 'collisions': 11}, {'tx': 27, 'success': 15, 'collisions': 12}, {'tx': 8, 'success': 3, 'collisions': 5}, {'tx': 39, 'success': 22, 'collisions': 17}, {'tx': 17, 'success': 5, 'collisions': 12}, {'tx': 33, 'success': 19, 'collisions': 14}, {'tx': 9, 'success': 2, 'collisions': 7}, {'tx': 25, 'success': 11, 'collisions': 14}, {'tx': 32, 'success': 15, 'collisions': 17}, {'tx': 20, 'success': 9, 'collisions': 11}]"
32,20,33,426,202,224,0.5258215962441315,0.47417840375586856,0.6666,"[{'tx': 5, 'success': 0, 'collisions': 5}, {'tx': 26, 'success': 11, 'collisions': 15}, {'tx': 5, 'success': 0, 'collisions': 5}, {'tx': 36, 'success': 17, 'collisions': 19}, {'tx': 12, 'success': 4, 'collisions': 8}, {'tx': 17, 'success': 9, 'collisions': 8}, {'tx': 26, 'success': 12, 'collisions': 14}, {'tx': 23, 'success': 10, 'collisions': 13}, {'tx': 36, 'success': 25, 'collisions': 11}, {'tx': 21, 'success': 9, 'collisions': 12}, {'tx': 21, 'success': 11, 'collisions': 10}, {'tx': 8, 'success': 2, 'collisions': 6}, {'tx': 23, 'success': 11, 'collisions': 12}, {'tx': 33, 'success': 21, 'collisions': 12}, {'tx': 27, 'success': 16, 'collisions': 11}, {'tx': 16, 'success': 6, 'collisions': 10}, {'tx': 26, 'success': 12, 'collisions': 14}, {'tx': 16, 'success': 5, 'collisions': 11}, {'tx': 23, 'success': 8, 'collisions': 15}, {'tx': 26, 'success': 13, 'collisions': 13}]"
33,20,34,420,193,227,0.5404761904761904,0.4595238095238095,0.6562,"[{'tx': 10, 'success': 3, 'collisions': 7}, {'tx': 17, 'success': 6, 'collisions': 11}, {'tx': 40, 'success': 25, 'collisions': 15}, {'tx': 24, 'success': 11, 'collisions': 13}, {'tx': 36, 'success': 22, 'collisions': 14}, {'tx': 27, 'success': 13, 'collisions': 14}, {'tx': 26, 'success': 13, 'collisions': 13}, {'tx': 29, 'success': 16, 'collisions': 13}, {'tx': 30, 'success': 18, 'collisions': 12}, {'tx': 37, 'success': 21, 'collisions': 16}, {'tx': 14, 'success': 5, 'collisions': 9}, {'tx': 23, 'success': 10, 'collisions': 13}, {'tx': 20, 'success': 8, 'collisions': 12}, {'tx': 8, 'success': 1, 'collisions': 7}, {'tx': 14, 'success': 5, 'collisions': 9}, {'tx': 8, 'success': 2, 'collisions': 6}, {'tx': 10, 'success': 1, 'collisions': 9}, {'tx': 20, 'success': 7, 'collisions': 13}, {'tx': 12, 'success': 2, 'collisions': 10}, {'tx': 15, 'success': 4, 'collisions': 11}]"
34,20,35,400,183,217,0.5425,0.4575,0.6405,"[{'tx': 12, 'success': 3, 'collisions': 9}, {'tx': 11, 'success': 3, 'collisions': 8}, {'tx': 5, 'success': 0, 'collisions': 5}, {'tx': 23, 'success': 9, 'collisions': 14}, {'tx': 15, 'success': 6, 'collisions': 9}, {'tx': 16, 'success': 6, 'collisions': 10}, {'tx': 32, 'success': 17, 'collisions': 15}, {'tx': 13, 'success': 4, 'collisions': 9}, {'tx': 27, 'success': 15, 'collisions': 12}, {'tx': 22, 'success': 12, 'collisions': 10}, {'tx': 33, 'success': 18, 'collisions': 15}, {'tx': 34, 'success': 20, 'collisions': 14}, {'tx': 10, 'success': 3, 'collisions': 7}, {'tx': 18, 'success': 8, 'collisions': 10}, {'tx': 13, 'success': 4, 'collisions': 9}, {'tx': 15, 'success': 3, 'collisions': 12}, {'tx': 32, 'success': 16, 'collisions': 16}, {'tx': 23, 'success': 13, 'collisions': 10}, {'tx': 10, 'success': 1, 'collisions': 9}, {'tx': 36, 'success': 22, 'collisions': 14}]"
35,20,36,403,177,226,0.5607940446650124,0.4392059553349876,0.6372,"[{'tx': 12, 'success': 5, 'collisions': 7}, {'tx': 33, 'success': 18, 'collisions': 15}, {'tx': 32, 'success': 20, 'collisions': 12}, {'tx': 23, 'success': 9, 'collisions': 14}, {'tx': 13, 'success': 4, 'collisions': 9}, {'tx': 26, 'success': 13, 'collisions': 13}, {'tx': 21, 'success': 6, 'collisions': 15}, {'tx': 17, 'success': 9, 'collisions': 8}, {'tx': 13, 'success': 4, 'collisions': 9}, {'tx': 18, 'success': 7, 'collisions': 11}, {'tx': 24, 'success': 11, 'collisions': 13}, {'tx': 28, 'success': 14, 'collisions': 14}, {'tx': 6, 'success': 0, 'collisions': 6}, {'tx': 23, 'success': 9, 'collisions': 14}, {'tx': 5, 'success': 0, 'collisions': 5}, {'tx': 7, 'success': 1, 'collisions': 6}, {'tx': 16, 'success': 5, 'collisions': 11}, {'tx': 34, 'success': 19, 'collisions': 15}, {'tx': 33, 'success': 16, 'collisions': 17}, {'tx': 19, 'success': 7, 'collisions': 12}]"
36,20,37,387,163,224,0.5788113695090439,0.42118863049095606,0.6031,"[{'tx': 39, 'success': 24, 'collisions': 15}, {'tx': 5, 'success': 0, 'collisions': 5}, {'tx': 6, 'success': 0, 'collisions': 6}, {'tx': 15, 'success': 4, 'collisions': 11}, {'tx': 19, 'success': 7, 'collisions': 12}, {'tx': 29, 'success': 15, 'collisions': 14}, {'tx': 20, 'success': 8, 'collisions': 12}, {'tx': 14, 'success': 4, 'collisions': 10}, {'tx': 26, 'success': 13, 'collisions': 13}, {'tx': 6, 'success': 0, 'collisions': 6}, {'tx': 26, 'success': 10, 'collisions': 16}, {'tx': 14, 'success': 6, 'collisions': 8}, {'tx': 18, 'success': 8, 'collisions': 10}, {'tx': 20, 'success': 7, 'collisions': 13}, {'tx': 7, 'success': 1, 'collisions': 6}, {'tx': 30, 'success': 13, 'collisions': 17}, {'tx': 32, 'success': 19, 'collisions': 13}, {'tx': 13, 'success': 3, 'collisions': 10}, {'tx': 25, 'success': 12, 'collisions': 13}, {'tx': 23, 'success': 9, 'collisions': 14}]"
37,20,38,375,168,207,0.552,0.448,0.6384,"[{'tx': 10, 'success': 4, 'collisions': 6}, {'tx': 6, 'success': 1, 'collisions': 5}, {'tx': 11, 'success': 2, 'collisions': 9}, {'tx': 10, 'success': 2, 'collisions': 8}, {'tx': 30, 'success': 17, 'collisions': 13}, {'tx': 30, 'success': 13, 'collisions': 17}, {'tx': 21, 'success': 9, 'collisions': 12}, {'tx': 6, 'success': 0, 'collisions': 6}, {'tx': 19, 'success': 7, 'collisions': 12}, {'tx': 12, 'success': 6, 'collisions': 6}, {'tx': 29, 'success': 17, 'collisions': 12}, {'tx': 14, 'success': 6, 'collisions': 8}, {'tx': 20, 'success': 11, 'collisions': 9}, {'tx': 20, 'success': 9, 'collisions': 11}, {'tx': 23, 'success': 9, 'collisions': 14}, {'tx': 26, 'success': 14, 'collisions': 12}, {'tx': 24, 'success': 11, 'collisions': 13}, {'tx': 14, 'success': 6, 'collisions': 8}, {'tx': 27, 'success': 11, 'collisions': 16}, {'tx': 23, 'success': 13, 'collisions': 10}]"
38,20,39,360,168,192,0.5333333333333333,0.4666666666666667,0.6552,"[{'tx': 34, 'success': 19, 'collisions': 15}, {'tx': 20, 'success': 8, 'collisions': 12}, {'tx': 30, 'success': 19, 'collisions': 11}, {'tx': 11, 'success': 3, 'collisions': 8}, {'tx': 14, 'success': 5, 'collisions': 9}, {'tx': 7, 'success': 1, 'collisions': 6}, {'tx': 9, 'success': 3, 'collisions': 6}, {'tx': 29, 'success': 18, 'collisions': 11}, {'tx': 21, 'success': 9, 'collisions': 12}, {'tx': 6, 'success': 0, 'collisions': 6}, {'tx': 17, 'success': 9, 'collisions': 8}, {'tx': 26, 'success': 14, 'collisions': 12}, {'tx': 12, 'success': 4, 'collisions': 8}, {'tx': 11, 'success': 4, 'collisions': 7}, {'tx': 10, 'success': 3, 'collisions': 7}, {'tx': 18, 'success': 8, 'collisions': 10}, {'tx': 24, 'success': 12, 'collisions': 12}, {'tx': 20, 'success': 9, 'collisions': 11}, {'tx': 17, 'success': 6, 'collisions': 11}, {'tx': 24, 'success': 14, 'collisions': 10}]"
39,20,40,366,154,212,0.5792349726775956,0.4207650273224044,0.616,"[{'tx': 17, 'success': 7, 'collisions': 10}, {'tx': 27, 'success': 13, 'collisions': 14}, {'tx': 10, 'success': 3, 'collisions': 7}, {'tx': 13, 'success': 5, 'collisions': 8}, {'tx': 6, 'success': 0, 'collisions': 6}, {'tx': 24, 'success': 12, 'collisions': 12}, {'tx': 12, 'success': 5, 'collisions': 7}, {'tx': 13, 'success': 4, 'collisions': 9}, {'tx': 14, 'success': 3, 'collisions': 11}, {'tx': 25, 'success': 12, 'collisions': 13}, {'tx': 29, 'success': 13, 'collisions': 16}, {'tx': 8, 'success': 1, 'collisions': 7}, {'tx': 11, 'success': 4, 'collisions': 7}, {'tx': 16, 'success': 7, 'collisions': 9}, {'tx': 29, 'success': 16, 'collisions': 13}, {'tx': 24, 'success': 11, 'collisions': 13}, {'tx': 21, 'success': 7, 'collisions': 14}, {'tx': 28, 'success': 15, 'collisions': 13}, {'tx': 20, 'success': 8, 'collisions': 12}, {'tx': 19, 'success': 8, 'collisions': 11}]"
40,20,41,362,156,206,0.569060773480663,0.430939226519337,0.6396,"[{'tx': 6, 'success': 0, 'collisions': 6}, {'tx': 21, 'success': 9, 'collisions': 12}, {'tx': 20, 'success': 8, 'collisions': 12}, {'tx': 23, 'success': 10, 'collisions': 13}, {'tx': 22, 'success': 12, 'collisions': 10}, {'tx': 26, 'success': 14, 'collisions': 12}, {'tx': 26, 'success': 11, 'collisions': 15}, {'tx': 14, 'success': 3, 'collisions': 11}, {'tx': 11, 'success': 2, 'collisions': 9}, {'tx': 25, 'success': 11, 'collisions': 14}, {'tx': 17, 'success': 8, 'collisions': 9}, {'tx': 5, 'success': 0, 'collisions': 5}, {'tx': 25, 'success': 13, 'collisions': 12}, {'tx': 11, 'success': 6, 'collisions': 5}, {'tx': 23, 'success': 13, 'collisions': 10}, {'tx': 15, 'success': 4, 'collisions': 11}, {'tx': 15, 'success': 5, 'collisions': 10}, {'tx': 26, 'success': 13, 'collisions': 13}, {'tx': 12, 'success': 4, 'collisions': 8}, {'tx': 19, 'success': 10, 'collisions': 9}]"
41,20,42,350,151,199,0.5685714285714286,0.43142857142857144,0.6342,"[{'tx': 17, 'success': 6, 'collisions': 11}, {'tx': 11, 'success': 4, 'collisions': 7}, {'tx': 32, 'success': 17, 'collisions': 15}, {'tx': 26, 'success': 12, 'collisions': 14}, {'tx': 29, 'success': 16, 'collisions': 13}, {'tx': 17, 'success': 5, 'collisions': 12}, {'tx': 8, 'success': 2, 'collisions': 6}, {'tx': 13, 'success': 4, 'collisions': 9}, {'tx': 6, 'success': 1, 'collisions': 5}, {'tx': 28, 'success': 16, 'collisions': 12}, {'tx': 10, 'success': 2, 'collisions': 8}, {'tx': 30, 'success': 14, 'collisions': 16}, {'tx': 18, 'success': 8, 'collisions': 10}, {'tx': 27, 'success': 14, 'collisions': 13}, {'tx': 5, 'success': 0, 'collisions': 5}, {'tx': 5, 'success': 0, 'collisions': 5}, {'tx': 9, 'success': 2, 'collisions': 7}, {'tx': 5, 'success': 0, 'collisions': 5}, {'tx': 24, 'success': 11, 'collisions': 13}, {'tx': 30, 'success': 17, 'collisions': 13}]"
42,20,43,345,145,200,0.5797101449275363,0.42028985507246375,0.6235,"[{'tx': 7, 'success': 2, 'collisions': 5}, {'tx': 5, 'success': 0, 'collisions': 5}, {'tx': 19, 'success': 8, 'collisions': 11}, {'tx': 20, 'success': 8, 'collisions': 12}, {'tx': 29, 'success': 15, 'collisions': 14}, {'tx': 20, 'success': 9, 'collisions': 11}, {'tx': 23, 'success': 7, 'collisions': 16}, {'tx': 11, 'success': 3, 'collisions': 8}, {'tx': 5, 'success': 0, 'collisions': 5}, {'tx': 19, 'success': 8, 'collisions': 11}, {'tx': 22, 'success': 11, 'collisions': 11}, {'tx': 21, 'success': 9, 'collisions': 12}, {'tx': 16, 'success': 5, 'collisions': 11}, {'tx': 17, 'success': 7, 'collisions': 10}, {'tx': 17, 'success': 7, 'collisions': 10}, {'tx': 31, 'success': 17, 'collisions': 14}, {'tx': 14, 'success': 6, 'collisions': 8}, {'tx': 10, 'success': 3, 'collisions': 7}, {'tx': 29, 'success': 16, 'collisions': 13}, {'tx': 10, 'success': 4, 'collisions': 6}]"
43,20,44,332,142,190,0.572289156626506,0.42771084337349397,0.6248,"[{'tx': 18, 'success': 8, 'collisions': 10}, {'tx': 5, 'success': 0, 'collisions': 5}, {'tx': 8, 'success': 2, 'collisions': 6}, {'tx': 25, 'success': 13, 'collisions': 12}, {'tx': 19, 'success': 8, 'collisions': 11}, {'tx': 17, 'success': 8, 'collisions': 9}, {'tx': 25, 'success': 9, 'collisions': 16}, {'tx': 21, 'success': 8, 'collisions': 13}, {'tx': 5, 'success': 0, 'collisions': 5}, {'tx': 21, 'success': 9, 'collisions': 12}, {'tx': 24, 'success': 11, 'collisions': 13}, {'tx': 8, 'success': 2, 'collisions': 6}, {'tx': 23, 'success': 12, 'collisions': 11}, {'tx': 21, 'success': 11, 'collisions': 10}, {'tx': 22, 'success': 10, 'collisions': 12}, {'tx': 5, 'success': 0, 'collisions': 5}, {'tx': 24, 'success': 12, 'collisions': 12}, {'tx': 25, 'success': 15, 'collisions': 10}, {'tx': 5, 'success': 0, 'collisions': 5}, {'tx': 11, 'success': 4, 'collisions': 7}]"
44,20,45,324,143,181,0.558641975308642,0.44135802469135804,0.6435,"[{'tx': 19, 'success': 9, 'collisions': 10}, {'tx': 6, 'success': 1, 'collisions': 5}, {'tx': 9, 'success': 2, 'collisions': 7}, {'tx': 13, 'success': 5, 'collisions': 8}, {'tx': 14, 'success': 4, 'collisions': 10}, {'tx': 20, 'success': 9, 'collisions': 11}, {'tx': 9, 'success': 1, 'collisions': 8}, {'tx': 22, 'success': 12, 'collisions': 10}, {'tx': 19, 'success': 9, 'collisions': 10}, {'tx': 25, 'success': 14, 'collisions': 11}, {'tx': 16, 'success': 6, 'collisions': 10}, {'tx': 14, 'success': 6, 'collisions': 8}, {'tx': 15, 'success': 6, 'collisions': 9}, {'tx': 6, 'success': 1, 'collisions': 5}, {'tx': 18, 'success': 6, 'collisions': 12}, {'tx': 17, 'success': 9, 'collisions': 8}, {'tx': 21, 'success': 9, 'collisions': 12}, {'tx': 24, 'success': 16, 'collisions': 8}, {'tx': 19, 'success': 8, 'collisions': 11}, {'tx': 18, 'success': 10, 'collisions': 8}]"
45,20,46,319,132,187,0.5862068965517241,0.41379310344827586,0.6072,"[{'tx': 5, 'success': 0, 'collisions': 5}, {'tx': 5, 'success': 0, 'collisions': 5}, {'tx': 20, 'success': 7, 'collisions': 13}, {'tx': 28, 'success': 14, 'collisions': 14}, {'tx': 26, 'success': 14, 'collisions': 12}, {'tx': 12, 'success': 2, 'collisions': 10}, {'tx': 18, 'success': 6, 'collisions': 12}, {'tx': 7, 'success': 1, 'collisions': 6}, {'tx': 16, 'success': 7, 'collisions': 9}, {'tx': 5, 'success': 0, 'collisions': 5}, {'tx': 10, 'success': 4, 'collisions': 6}, {'tx': 33, 'success': 17, 'collisions': 16}, {'tx': 21, 'success': 10, 'collisions': 11}, {'tx': 31, 'success': 21, 'collisions': 10}, {'tx': 14, 'success': 4, 'collisions': 10}, {'tx': 21, 'success': 9, 'collisions': 12}, {'tx': 12, 'success': 5, 'collisions': 7}, {'tx': 17, 'success': 7, 'collisions': 10}, {'tx': 10, 'success': 2, 'collisions': 8}, {'tx': 8, 'success': 2, 'collisions': 6}]"
46,20,47,314,128,186,0.5923566878980892,0.40764331210191085,0.6016,"[{'tx': 5, 'success': 0, 'collisions': 5}, {'tx': 16, 'success': 6, 'collisions': 10}, {'tx': 17, 'success': 6, 'collisions': 11}, {'tx': 22, 'success': 11, 'collisions': 11}, {'tx': 35, 'success': 19, 'collisions': 16}, {'tx': 20, 'success': 9, 'collisions': 11}, {'tx': 11, 'success': 3, 'collisions': 8}, {'tx': 8, 'success': 1, 'collisions': 7}, {'tx': 8, 'success': 2, 'collisions': 6}, {'tx': 8, 'success': 1, 'collisions': 7}, {'tx': 14, 'success': 5, 'collisions': 9}, {'tx': 14, 'success': 6, 'collisions': 8}, {'tx': 17, 'success': 7, 'collisions': 10}, {'tx': 25, 'success': 13, 'collisions': 12}, {'tx': 5, 'success': 0, 'collisions': 5}, {'tx': 23, 'success': 12, 'collisions': 11}, {'tx': 17, 'success': 6, 'collisions': 11}, {'tx': 29, 'success': 15, 'collisions': 14}, {'tx': 13, 'success': 5, 'collisions': 8}, {'tx': 7, 'success': 1, 'collisions': 6}]"
47,20,48,311,125,186,0.5980707395498392,0.40192926045016075,0.6,"[{'tx': 15, 'success': 5, 'collisions': 10}, {'tx': 8, 'success': 2, 'collisions': 6}, {'tx': 23, 'success': 8, 'collisions': 15}, {'tx': 16, 'success': 8, 'collisions': 8}, {'tx': 31, 'success': 19, 'collisions': 12}, {'tx': 6, 'success': 1, 'collisions': 5}, {'tx': 25, 'success': 14, 'collisions': 11}, {'tx': 9, 'success': 2, 'collisions': 7}, {'tx': 22, 'success': 9, 'collisions': 13}, {'tx': 6, 'success': 0, 'collisions': 6}, {'tx': 8, 'success': 2, 'collisions': 6}, {'tx': 13, 'success': 5, 'collisions': 8}, {'tx': 17, 'success': 5, 'collisions': 12}, {'tx': 4, 'success': 0, 'collisions': 4}, {'tx': 22, 'success': 11, 'collisions': 11}, {'tx': 16, 'success': 7, 'collisions': 9}, {'tx': 12, 'success': 5, 'collisions': 7}, {'tx': 16, 'success': 5, 'collisions': 11}, {'tx': 18, 'success': 7, 'collisions': 11}, {'tx': 24, 'success': 10, 'collisions': 14}]"
48,20,49,298,128,170,0.5704697986577181,0.42953020134228187,0.6272,"[{'tx': 17, 'success': 8, 'collisions': 9}, {'tx': 28, 'success': 13, 'collisions': 15}, {'tx': 17, 'success': 8, 'collisions': 9}, {'tx': 7, 'success': 1, 'collisions': 6}, {'tx': 5, 'success': 0, 'collisions': 5}, {'tx': 22, 'success': 11, 'collisions': 11}, {'tx': 20, 'success': 10, 'collisions': 10}, {'tx': 10, 'success': 4, 'collisions': 6}, {'tx': 23, 'success': 11, 'collisions': 12}, {'tx': 18, 'success': 10, 'collisions': 8}, {'tx': 5, 'success': 0, 'collisions': 5}, {'tx': 8, 'success': 2, 'collisions': 6}, {'tx': 9, 'success': 1, 'collisions': 8}, {'tx': 15, 'success': 5, 'collisions': 10}, {'tx': 16, 'success': 9, 'collisions': 7}, {'tx': 6, 'success': 1, 'collisions': 5}, {'tx': 21, 'success': 11, 'collisions': 10}, {'tx': 22, 'success': 11, 'collisions': 11}, {'tx': 18, 'success': 9, 'collisions': 9}, {'tx': 11, 'success': 3, 'collisions': 8}]"
49,20,50,294,126,168,0.5714285714285714,0.42857142857142855,0.63,"[{'tx': 12, 'success': 3, 'collisions': 9}, {'tx': 8, 'success': 1, 'collisions': 7}, {'tx': 15, 'success': 6, 'collisions': 9}, {'tx': 16, 'success': 7, 'collisions': 9}, {'tx': 18, 'success': 7, 'collisions': 11}, {'tx': 15, 'success': 9, 'collisions': 6}, {'tx': 12, 'success': 4, 'collisions': 8}, {'tx': 20, 'success': 7, 'collisions': 13}, {'tx': 24, 'success': 14, 'collisions': 10}, {'tx': 16, 'success': 7, 'collisions': 9}, {'tx': 6, 'success': 1, 'collisions': 5}, {'tx': 12, 'success': 4, 'collisions': 8}, {'tx': 14, 'success': 6, 'collisions': 8}, {'tx': 22, 'success': 14, 'collisions': 8}, {'tx': 25, 'success': 11, 'collisions': 14}, {'tx': 6, 'success': 1, 'collisions': 5}, {'tx': 11, 'success': 4, 'collisions': 7}, {'tx': 7, 'success': 2, 'collisions': 5}, {'tx': 23, 'success': 13, 'collisions': 10}, {'tx': 12, 'success': 5, 'collisions': 7}]"
50,20,51,291,126,165,0.5670103092783505,0.4329896907216495,0.6426,"[{'tx': 10, 'success': 4, 'collisions': 6}, {'tx': 8, 'success': 1, 'collisions': 7}, {'tx': 17, 'success': 5, 'collisions': 12}, {'tx': 20, 'success': 12, 'collisions': 8}, {'tx': 19, 'success': 8, 'collisions': 11}, {'tx': 6, 'success': 0, 'collisions': 6}, {'tx': 30, 'success': 20, 'collisions': 10}, {'tx': 11, 'success': 3, 'collisions': 8}, {'tx': 19, 'success': 9, 'collisions': 10}, {'tx': 17, 'success': 7, 'collisions': 10}, {'tx': 28, 'success': 16, 'collisions': 12}, {'tx': 14, 'success': 6, 'collisions': 8}, {'tx': 5, 'success': 0, 'collisions': 5}, {'tx': 22, 'success': 11, 'collisions': 11}, {'tx': 13, 'success': 5, 'collisions': 8}, {'tx': 14, 'success': 7, 'collisions': 7}, {'tx': 5, 'success': 0, 'collisions': 5}, {'tx': 22, 'success': 11, 'collisions': 11}, {'tx': 4, 'success': 0, 'collisions': 4}, {'tx': 7, 'success': 1, 'collisions': 6}]"
51,20,52,293,112,181,0.6177474402730375,0.3822525597269625,0.5824,"[{'tx': 17, 'success': 8, 'collisions': 9}, {'tx': 19, 'success': 8, 'collisions': 11}, {'tx': 16, 'success': 6, 'collisions': 10}, {'tx': 23, 'success': 10, 'collisions': 13}, {'tx': 25, 'success': 12, 'collisions': 13}, {'tx': 17, 'success': 6, 'collisions': 11}, {'tx': 16, 'success': 7, 'collisions': 9}, {'tx': 15, 'success': 7, 'collisions': 8}, {'tx': 15, 'success': 7, 'collisions': 8}, {'tx': 10, 'success': 3, 'collisions': 7}, {'tx': 16, 'success': 6, 'collisions': 10}, {'tx': 14, 'success': 4, 'collisions': 10}, {'tx': 17, 'success': 7, 'collisions': 10}, {'tx': 20, 'success': 9, 'collisions': 11}, {'tx': 8, 'success': 1, 'collisions': 7}, {'tx': 11, 'success': 4, 'collisions': 7}, {'tx': 10, 'success': 2, 'collisions': 8}, {'tx': 5, 'success': 0, 'collisions': 5}, {'tx': 8, 'success': 2, 'collisions': 6}, {'tx': 11, 'success': 3, 'collisions': 8}]"
52,20,53,278,117,161,0.579136690647482,0.420863309352518,0.6201,"[{'tx': 9, 'success': 2, 'collisions': 7}, {'tx': 6, 'success': 0, 'collisions': 6}, {'tx': 17, 'success': 9, 'collisions': 8}, {'tx': 14, 'success': 6, 'collisions': 8}, {'tx': 26, 'success': 11, 'collisions': 15}, {'tx': 5, 'success': 0, 'collisions': 5}, {'tx': 10, 'success': 3, 'collisions': 7}, {'tx': 16, 'success': 6, 'collisions': 10}, {'tx': 29, 'success': 20, 'collisions': 9}, {'tx': 20, 'success': 10, 'collisions': 10}, {'tx': 21, 'success': 11, 'collisions': 10}, {'tx': 12, 'success': 4, 'collisions': 8}, {'tx': 11, 'success': 3, 'collisions': 8}, {'tx': 24, 'success': 12, 'collisions': 12}, {'tx': 9, 'success': 2, 'collisions': 7}, {'tx': 8, 'success': 2, 'collisions': 6}, {'tx': 7, 'success': 1, 'collisions': 6}, {'tx': 23, 'success': 14, 'collisions': 9}, {'tx': 6, 'success': 1, 'collisions': 5}, {'tx': 5, 'success': 0, 'collisions': 5}]"
53,20,54,274,112,162,0.5912408759124088,0.40875912408759124,0.6048,"[{'tx': 17, 'success': 6, 'collisions': 11}, {'tx': 22, 'success': 13, 'collisions': 9}, {'tx': 12, 'success': 5, 'collisions': 7}, {'tx': 9, 'success': 2, 'collisions': 7}, {'tx': 28, 'success': 11, 'collisions': 17}, {'tx': 17, 'success': 8, 'collisions': 9}, {'tx': 12, 'success': 5, 'collisions': 7}, {'tx': 4, 'success': 0, 'collisions': 4}, {'tx': 12, 'success': 5, 'collisions': 7}, {'tx': 7, 'success': 2, 'collisions': 5}, {'tx': 13, 'success': 4, 'collisions': 9}, {'tx': 14, 'success': 6, 'collisions': 8}, {'tx': 13, 'success': 6, 'collisions': 7}, {'tx': 7, 'success': 2, 'collisions': 5}, {'tx': 11, 'success': 5, 'collisions': 6}, {'tx': 14, 'success': 6, 'collisions': 8}, {'tx': 14, 'success': 5, 'collisions': 9}, {'tx': 19, 'success': 8, 'collisions': 11}, {'tx': 21, 'success': 12, 'collisions': 9}, {'tx': 8, 'success': 1, 'collisions': 7}]"
54,20,55,273,115,158,0.5787545787545788,0.42124542124542125,0.6325,"[{'tx': 5, 'success': 1, 'collisions': 4}, {'tx': 26, 'success': 17, 'collisions': 9}, {'tx': 9, 'success': 2, 'collisions': 7}, {'tx': 6, 'success': 1, 'collisions': 5}, {'tx': 13, 'success': 6, 'collisions': 7}, {'tx': 22, 'success': 13, 'collisions': 9}, {'tx': 18, 'success': 7, 'collisions': 11}, {'tx': 11, 'success': 4, 'collisions': 7}, {'tx': 13, 'success': 6, 'collisions': 7}, {'tx': 13, 'success': 5, 'collisions': 8}, {'tx': 12, 'success': 3, 'collisions': 9}, {'tx': 15, 'success': 6, 'collisions': 9}, {'tx': 15, 'success': 6, 'collisions': 9}, {'tx': 15, 'success': 5, 'collisions': 10}, {'tx': 14, 'success': 6, 'collisions': 8}, {'tx': 4, 'success': 0, 'collisions': 4}, {'tx': 14, 'success': 6, 'collisions': 8}, {'tx': 19, 'success': 10, 'collisions': 9}, {'tx': 19, 'success': 8, 'collisions': 11}, {'tx': 10, 'success': 3, 'collisions': 7}]"
55,20,56,270,115,155,0.5740740740740741,0.42592592592592593,0.644,"[{'tx': 7, 'success': 1, 'collisions': 6}, {'tx': 8, 'success': 2, 'collisions': 6}, {'tx': 19, 'success': 12, 'collisions': 7}, {'tx': 12, 'success': 6, 'collisions': 6}, {'tx': 7, 'success': 1, 'collisions': 6}, {'tx': 21, 'success': 11, 'collisions': 10}, {'tx': 11, 'success': 3, 'collisions': 8}, {'tx': 9, 'success': 2, 'collisions': 7}, {'tx': 4, 'success': 0, 'collisions': 4}, {'tx': 18, 'success': 9, 'collisions': 9}, {'tx': 13, 'success': 6, 'collisions': 7}, {'tx': 22, 'success': 10, 'collisions': 12}, {'tx': 16, 'success': 6, 'collisions': 10}, {'tx': 6, 'success': 1, 'collisions': 5}, {'tx': 19, 'success': 9, 'collisions': 10}, {'tx': 5, 'success': 0, 'collisions': 5}, {'tx': 26, 'success': 17, 'collisions': 9}, {'tx': 11, 'success': 5, 'collisions': 6}, {'tx': 18, 'success': 7, 'collisions': 11}, {'tx': 18, 'success': 7, 'collisions': 11}]"
56,20,57,257,113,144,0.5603112840466926,0.4396887159533074,0.6441,"[{'tx': 8, 'success': 1, 'collisions': 7}, {'tx': 4, 'success': 0, 'collisions': 4}, {'tx': 8, 'success': 2, 'collisions': 6}, {'tx': 20, 'success': 12, 'collisions': 8}, {'tx': 4, 'success': 0, 'collisions': 4}, {'tx': 16, 'success': 8, 'collisions': 8}, {'tx': 23, 'success': 13, 'collisions': 10}, {'tx': 19, 'success': 11, 'collisions': 8}, {'tx': 18, 'success': 10, 'collisions': 8}, {'tx': 5, 'success': 1, 'collisions': 4}, {'tx': 17, 'success': 5, 'collisions': 12}, {'tx': 11, 'success': 3, 'collisions': 8}, {'tx': 12, 'success': 5, 'collisions': 7}, {'tx': 17, 'success': 10, 'collisions': 7}, {'tx': 20, 'success': 11, 'collisions': 9}, {'tx': 16, 'success': 8, 'collisions': 8}, {'tx': 9, 'success': 3, 'collisions': 6}, {'tx': 15, 'success': 6, 'collisions': 9}, {'tx': 7, 'success': 1, 'collisions': 6}, {'tx': 8, 'success': 3, 'collisions': 5}]"
57,20,58,249,113,136,0.5461847389558233,0.4538152610441767,0.6554,"[{'tx': 13, 'success': 6, 'collisions': 7}, {'tx': 4, 'success': 0, 'collisions': 4}, {'tx': 14, 'success': 7, 'collisions': 7}, {'tx': 21, 'success': 14, 'collisions': 7}, {'tx': 5, 'success': 0, 'collisions': 5}, {'tx': 12, 'success': 5, 'collisions': 7}, {'tx': 17, 'success': 9, 'collisions': 8}, {'tx': 5, 'success': 1, 'collisions': 4}, {'tx': 20, 'success': 11, 'collisions': 9}, {'tx': 18, 'success': 9, 'collisions': 9}, {'tx': 9, 'success': 2, 'collisions': 7}, {'tx': 10, 'success': 2, 'collisions': 8}, {'tx': 19, 'success': 11, 'collisions': 8}, {'tx': 5, 'success': 0, 'collisions': 5}, {'tx': 16, 'success': 7, 'collisions': 9}, {'tx': 5, 'success': 0, 'collisions': 5}, {'tx': 24, 'success': 18, 'collisions': 6}, {'tx': 14, 'success': 5, 'collisions': 9}, {'tx': 14, 'success': 6, 'collisions': 8}, {'tx': 4, 'success': 0, 'collisions': 4}]"
58,20,59,247,104,143,0.5789473684210527,0.42105263157894735,0.6136,"[{'tx': 27, 'success': 19, 'collisions': 8}, {'tx': 16, 'success': 6, 'collisions': 10}, {'tx': 9, 'success': 2, 'collisions': 7}, {'tx': 21, 'success': 11, 'collisions': 10}, {'tx': 6, 'success': 0, 'collisions': 6}, {'tx': 5, 'success': 0, 'collisions': 5}, {'tx': 9, 'success': 2, 'collisions': 7}, {'tx': 4, 'success': 0, 'collisions': 4}, {'tx': 16, 'success': 9, 'collisions': 7}, {'tx': 5, 'success': 0, 'collisions': 5}, {'tx': 12, 'success': 5, 'collisions': 7}, {'tx': 4, 'success': 0, 'collisions': 4}, {'tx': 4, 'success': 0, 'collisions': 4}, {'tx': 12, 'success': 3, 'collisions': 9}, {'tx': 6, 'success': 1, 'collisions': 5}, {'tx': 16, 'success': 8, 'collisions': 8}, {'tx': 16, 'success': 8, 'collisions': 8}, {'tx': 17, 'success': 8, 'collisions': 9}, {'tx': 21, 'success': 11, 'collisions': 10}, {'tx': 21, 'success': 11, 'collisions': 10}]"
59,20,60,256,100,156,0.609375,0.390625,0.6,"[{'tx': 12, 'success': 4, 'collisions': 8}, {'tx': 8, 'success': 3, 'collisions': 5}, {'tx': 12, 'success': 5, 'collisions': 7}, {'tx': 18, 'success': 10, 'collisions': 8}, {'tx': 7, 'success': 1, 'collisions': 6}, {'tx': 4, 'success': 0, 'collisions': 4}, {'tx': 13, 'success': 5, 'collisions': 8}, {'tx': 9, 'success': 3, 'collisions': 6}, {'tx': 18, 'success': 9, 'collisions': 9}, {'tx': 12, 'success': 4, 'collisions': 8}, {'tx': 17, 'success': 8, 'collisions': 9}, {'tx': 17, 'success': 6, 'collisions': 11}, {'tx': 11, 'success': 4, 'collisions': 7}, {'tx': 18, 'success': 8, 'collisions': 10}, {'tx': 4, 'success': 0, 'collisions': 4}, {'tx': 7, 'success': 2, 'collisions': 5}, {'tx': 19, 'success': 9, 'collisions': 10}, {'tx': 17, 'success': 8, 'collisions': 9}, {'tx': 20, 'success': 6, 'collisions': 14}, {'tx': 13, 'success': 5, 'collisions': 8}]"
60,20,61,243,102,141,0.5802469135802469,0.41975308641975306,0.6222,"[{'tx': 12, 'success': 5, 'collisions': 7}, {'tx': 10, 'success': 3, 'collisions': 7}, {'tx': 11, 'success': 5, 'collisions': 6}, {'tx': 5, 'success': 1, 'collisions': 4}, {'tx': 16, 'success': 10, 'collisions': 6}, {'tx': 20, 'success': 7, 'collisions': 13}, {'tx': 16, 'success': 8, 'collisions': 8}, {'tx': 11, 'success': 5, 'collisions': 6}, {'tx': 8, 'success': 2, 'collisions': 6}, {'tx': 14, 'success': 6, 'collisions': 8}, {'tx': 16, 'success': 8, 'collisions': 8}, {'tx': 6, 'success': 1, 'collisions': 5}, {'tx': 13, 'success': 4, 'collisions': 9}, {'tx': 16, 'success': 7, 'collisions': 9}, {'tx': 14, 'success': 8, 'collisions': 6}, {'tx': 9, 'success': 4, 'collisions': 5}, {'tx': 13, 'success': 4, 'collisions': 9}, {'tx': 6, 'success': 1, 'collisions': 5}, {'tx': 11, 'success': 4, 'collisions': 7}, {'tx': 16, 'success': 9, 'collisions': 7}]"
61,20,62,240,101,139,0.5791666666666667,0.42083333333333334,0.6262,"[{'tx': 8, 'success': 3, 'collisions': 5}, {'tx': 9, 'success': 3, 'collisions': 6}, {'tx': 17, 'success': 11, 'collisions': 6}, {'tx': 6, 'success': 1, 'collisions': 5}, {'tx': 22, 'success': 11, 'collisions': 11}, {'tx': 15, 'success': 6, 'collisions': 9}, {'tx': 15, 'success': 6, 'collisions': 9}, {'tx': 5, 'success': 0, 'collisions': 5}, {'tx': 22, 'success': 12, 'collisions': 10}, {'tx': 11, 'success': 5, 'collisions': 6}, {'tx': 14, 'success': 6, 'collisions': 8}, {'tx': 7, 'success': 1, 'collisions': 6}, {'tx': 11, 'success': 2, 'collisions': 9}, {'tx': 12, 'success': 4, 'collisions': 8}, {'tx': 18, 'success': 11, 'collisions': 7}, {'tx': 12, 'success': 5, 'collisions': 7}, {'tx': 16, 'success': 10, 'collisions': 6}, {'tx': 4, 'success': 0, 'collisions': 4}, {'tx': 10, 'success': 3, 'collisions': 7}, {'tx': 6, 'success': 1, 'collisions': 5}]"
62,20,63,237,94,143,0.6033755274261603,0.39662447257383965,0.5922,"[{'tx': 5, 'success': 0, 'collisions': 5}, {'tx': 21, 'success': 10, 'collisions': 11}, {'tx': 5, 'success': 0, 'collisions': 5}, {'tx': 16, 'success': 6, 'collisions': 10}, {'tx': 9, 'success': 1, 'collisions': 8}, {'tx': 19, 'success': 10, 'collisions': 9}, {'tx': 10, 'success': 3, 'collisions': 7}, {'tx': 5, 'success': 0, 'collisions': 5}, {'tx': 12, 'success': 5, 'collisions': 7}, {'tx': 5, 'success': 0, 'collisions': 5}, {'tx': 5, 'success': 1, 'collisions': 4}, {'tx': 4, 'success': 0, 'collisions': 4}, {'tx': 23, 'success': 12, 'collisions': 11}, {'tx': 4, 'success': 0, 'collisions': 4}, {'tx': 14, 'success': 7, 'collisions': 7}, {'tx': 18, 'success': 7, 'collisions': 11}, {'tx': 12, 'success': 5, 'collisions': 7}, {'tx': 20, 'success': 10, 'collisions': 10}, {'tx': 11, 'success': 5, 'collisions': 6}, {'tx': 19, 'success': 12, 'collisions': 7}]"
63,20,64,236,91,145,0.614406779661017,0.3855932203389831,0.5824,"[{'tx': 4, 'success': 0, 'collisions': 4}, {'tx': 12, 'success': 6, 'collisions': 6}, {'tx': 8, 'success': 1, 'collisions': 7}, {'tx': 14, 'success': 5, 'collisions': 9}, {'tx': 10, 'success': 5, 'collisions': 5}, {'tx': 14, 'success': 6, 'collisions': 8}, {'tx': 20, 'success': 10, 'collisions': 10}, {'tx': 4, 'success': 0, 'collisions': 4}, {'tx': 16, 'success': 5, 'collisions': 11}, {'tx': 8, 'success': 2, 'collisions': 6}, {'tx': 15, 'success': 7, 'collisions': 8}, {'tx': 16, 'success': 5, 'collisions': 11}, {'tx': 6, 'success': 1, 'collisions': 5}, {'tx': 8, 'success': 2, 'collisions': 6}, {'tx': 17, 'success': 6, 'collisions': 11}, {'tx': 14, 'success': 9, 'collisions': 5}, {'tx': 13, 'success': 7, 'collisions': 6}, {'tx': 12, 'success': 6, 'collisions': 6}, {'tx': 12, 'success': 3, 'collisions': 9}, {'tx': 13, 'success': 5, 'collisions': 8}]"
64,20,65,228,100,128,0.5614035087719298,0.43859649122807015,0.65,"[{'tx': 21, 'success': 11, 'collisions': 10}, {'tx': 19, 'success': 9, 'collisions': 10}, {'tx': 9, 'success': 4, 'collisions': 5}, {'tx': 17, 'success': 10, 'collisions': 7}, {'tx': 7, 'success': 1, 'collisions': 6}, {'tx': 12, 'success': 6, 'collisions': 6}, {'tx': 7, 'success': 1, 'collisions': 6}, {'tx': 10, 'success': 4, 'collisions': 6}, {'tx': 4, 'success': 0, 'collisions': 4}, {'tx': 14, 'success': 7, 'collisions': 7}, {'tx': 9, 'success': 4, 'collisions': 5}, {'tx': 14, 'success': 6, 'collisions': 8}, {'tx': 10, 'success': 3, 'collisions': 7}, {'tx': 15, 'success': 9, 'collisions': 6}, {'tx': 4, 'success': 0, 'collisions': 4}, {'tx': 15, 'success': 7, 'collisions': 8}, {'tx': 7, 'success': 1, 'collisions': 6}, {'tx': 5, 'success': 0, 'collisions': 5}, {'tx': 19, 'success': 13, 'collisions': 6}, {'tx': 10, 'success': 4, 'collisions': 6}]"
65,20,66,226,94,132,0.584070796460177,0.415929203539823,0.6204,"[{'tx': 14, 'success': 5, 'collisions': 9}, {'tx': 9, 'success': 2, 'collisions': 7}, {'tx': 14, 'success': 8, 'collisions': 6}, {'tx': 4, 'success': 0, 'collisions': 4}, {'tx': 5, 'success': 0, 'collisions': 5}, {'tx': 8, 'success': 2, 'collisions': 6}, {'tx': 12, 'success': 6, 'collisions': 6}, {'tx': 14, 'success': 8, 'collisions': 6}, {'tx': 4, 'success': 0, 'collisions': 4}, {'tx': 12, 'success': 5, 'collisions': 7}, {'tx': 17, 'success': 9, 'collisions': 8}, {'tx': 20, 'success': 12, 'collisions': 8}, {'tx': 12, 'success': 6, 'collisions': 6}, {'tx': 8, 'success': 3, 'collisions': 5}, {'tx': 5, 'success': 1, 'collisions': 4}, {'tx': 18, 'success': 10, 'collisions': 8}, {'tx': 7, 'success': 1, 'collisions': 6}, {'tx': 15, 'success': 5, 'collisions': 10}, {'tx': 14, 'success': 5, 'collisions': 9}, {'tx': 14, 'success': 6, 'collisions': 8}]"
66,20,67,228,90,138,0.6052631578947368,0.39473684210526316,0.603,"[{'tx': 13, 'success': 5, 'collisions': 8}, {'tx': 8, 'success': 1, 'collisions': 7}, {'tx': 13, 'success': 5, 'collisions': 8}, {'tx': 5, 'success': 0, 'collisions': 5}, {'tx': 6, 'success': 1, 'collisions': 5}, {'tx': 8, 'success': 2, 'collisions': 6}, {'tx': 19, 'success': 8, 'collisions': 11}, {'tx': 18, 'success': 11, 'collisions': 7}, {'tx': 12, 'success': 5, 'collisions': 7}, {'tx': 13, 'success': 7, 'collisions': 6}, {'tx': 16, 'success': 6, 'collisions': 10}, {'tx': 14, 'success': 5, 'collisions': 9}, {'tx': 12, 'success': 4, 'collisions': 8}, {'tx': 5, 'success': 1, 'collisions': 4}, {'tx': 15, 'success': 7, 'collisions': 8}, {'tx': 4, 'success': 0, 'collisions': 4}, {'tx': 12, 'success': 4, 'collisions': 8}, {'tx': 15, 'success': 10, 'collisions': 5}, {'tx': 8, 'success': 2, 'collisions': 6}, {'tx': 12, 'success': 6, 'collisions': 6}]"
67,20,68,228,90,138,0.6052631578947368,0.39473684210526316,0.612,"[{'tx': 13, 'success': 3, 'collisions': 10}, {'tx': 12, 'success': 4, 'collisions': 8}, {'tx': 16, 'success': 10, 'collisions': 6}, {'tx': 8, 'success': 1, 'collisions': 7}, {'tx': 16, 'success': 8, 'collisions': 8}, {'tx': 12, 'success': 5, 'collisions': 7}, {'tx': 10, 'success': 2, 'collisions': 8}, {'tx': 14, 'success': 6, 'collisions': 8}, {'tx': 12, 'success': 3, 'collisions': 9}, {'tx': 5, 'success': 0, 'collisions': 5}, {'tx': 8, 'success': 3, 'collisions': 5}, {'tx': 11, 'success': 5, 'collisions': 6}, {'tx': 20, 'success': 11, 'collisions': 9}, {'tx': 5, 'success': 0, 'collisions': 5}, {'tx': 16, 'success': 8, 'collisions': 8}, {'tx': 14, 'success': 6, 'collisions': 8}, {'tx': 14, 'success': 8, 'collisions': 6}, {'tx': 9, 'success': 3, 'collisions': 6}, {'tx': 9, 'success': 4, 'collisions': 5}, {'tx': 4, 'success': 0, 'collisions': 4}]"
68,20,69,216,89,127,0.5879629629629629,0.41203703703703703,0.6141,"[{'tx': 7, 'success': 2, 'collisions': 5}, {'tx': 15, 'success': 7, 'collisions': 8}, {'tx': 4, 'success': 0, 'collisions': 4}, {'tx': 19, 'success': 11, 'collisions': 8}, {'tx': 14, 'success': 6, 'collisions': 8}, {'tx': 14, 'success': 7, 'collisions': 7}, {'tx': 9, 'success': 3, 'collisions': 6}, {'tx': 10, 'success': 5, 'collisions': 5}, {'tx': 16, 'success': 7, 'collisions': 9}, {'tx': 5, 'success': 0, 'collisions': 5}, {'tx': 4, 'success': 0, 'collisions': 4}, {'tx': 8, 'success': 3, 'collisions': 5}, {'tx': 5, 'success': 0, 'collisions': 5}, {'tx': 8, 'success': 2, 'collisions': 6}, {'tx': 12, 'success': 4, 'collisions': 8}, {'tx': 16, 'success': 8, 'collisions': 8}, {'tx': 7, 'success': 2, 'collisions': 5}, {'tx': 19, 'success': 12, 'collisions': 7}, {'tx': 19, 'success': 10, 'collisions': 9}, {'tx': 5, 'success': 0, 'collisions': 5}]"
69,20,70,214,86,128,0.5981308411214953,0.40186915887850466,0.602,"[{'tx': 9, 'success': 3, 'collisions': 6}, {'tx': 6, 'success': 1, 'collisions': 5}, {'tx': 9, 'success': 3, 'collisions': 6}, {'tx': 14, 'success': 5, 'collisions': 9}, {'tx': 14, 'success': 7, 'collisions': 7}, {'tx': 4, 'success': 0, 'collisions': 4}, {'tx': 9, 'success': 4, 'collisions': 5}, {'tx': 9, 'success': 2, 'collisions': 7}, {'tx': 5, 'success': 0, 'collisions': 5}, {'tx': 9, 'success': 2, 'collisions': 7}, {'tx': 4, 'success': 0, 'collisions': 4}, {'tx': 12, 'success': 5, 'collisions': 7}, {'tx': 15, 'success': 5, 'collisions': 10}, {'tx': 17, 'success': 10, 'collisions': 7}, {'tx': 7, 'success': 1, 'collisions': 6}, {'tx': 25, 'success': 13, 'collisions': 12}, {'tx': 11, 'success': 7, 'collisions': 4}, {'tx': 21, 'success': 15, 'collisions': 6}, {'tx': 10, 'success': 3, 'collisions': 7}, {'tx': 4, 'success': 0, 'collisions': 4}]"
70,20,71,208,90,118,0.5673076923076923,0.4326923076923077,0.639,"[{'tx': 4, 'success': 0, 'collisions': 4}, {'tx': 15, 'success': 9, 'collisions': 6}, {'tx': 17, 'success': 10, 'collisions': 7}, {'tx': 13, 'success': 6, 'collisions': 7}, {'tx': 21, 'success': 16, 'collisions': 5}, {'tx': 9, 'success': 3, 'collisions': 6}, {'tx': 10, 'success': 5, 'collisions': 5}, {'tx': 13, 'success': 5, 'collisions': 8}, {'tx': 8, 'success': 3, 'collisions': 5}, {'tx': 6, 'success': 1, 'collisions': 5}, {'tx': 4, 'success': 0, 'collisions': 4}, {'tx': 14, 'success': 6, 'collisions': 8}, {'tx': 5, 'success': 1, 'collisions': 4}, {'tx': 4, 'success': 0, 'collisions': 4}, {'tx': 13, 'success': 4, 'collisions': 9}, {'tx': 7, 'success': 2, 'collisions': 5}, {'tx': 17, 'success': 9, 'collisions': 8}, {'tx': 15, 'success': 7, 'collisions': 8}, {'tx': 8, 'success': 2, 'collisions': 6}, {'tx': 5, 'success': 1, 'collisions': 4}]"
71,20,72,207,83,124,0.5990338164251208,0.40096618357487923,0.5976,"[{'tx': 7, 'success': 1, 'collisions': 6}, {'tx': 7, 'success': 1, 'collisions': 6}, {'tx': 11, 'success': 6, 'collisions': 5}, {'tx': 12, 'success': 7, 'collisions': 5}, {'tx': 7, 'success': 2, 'collisions': 5}, {'tx': 11, 'success': 6, 'collisions': 5}, {'tx': 8, 'success': 3, 'collisions': 5}, {'tx': 16, 'success': 8, 'collisions': 8}, {'tx': 12, 'success': 2, 'collisions': 10}, {'tx': 14, 'success': 8, 'collisions': 6}, {'tx': 7, 'success': 1, 'collisions': 6}, {'tx': 13, 'success': 6, 'collisions': 7}, {'tx': 14, 'success': 6, 'collisions': 8}, {'tx': 4, 'success': 0, 'collisions': 4}, {'tx': 18, 'success': 9, 'collisions': 9}, {'tx': 6, 'success': 1, 'collisions': 5}, {'tx': 15, 'success': 7, 'collisions': 8}, {'tx': 13, 'success': 7, 'collisions': 6}, {'tx': 5, 'success': 0, 'collisions': 5}, {'tx': 7, 'success': 2, 'collisions': 5}]"
72,20,73,203,88,115,0.5665024630541872,0.43349753694581283,0.6424,"[{'tx': 5, 'success': 0, 'collisions': 5}, {'tx': 6, 'success': 1, 'collisions': 5}, {'tx': 5, 'success': 2, 'collisions': 3}, {'tx': 17, 'success': 8, 'collisions': 9}, {'tx': 16, 'success': 8, 'collisions': 8}, {'tx': 16, 'success': 8, 'collisions': 8}, {'tx': 18, 'success': 13, 'collisions': 5}, {'tx': 5, 'success': 0, 'collisions': 5}, {'tx': 8, 'success': 3, 'collisions': 5}, {'tx': 8, 'success': 2, 'collisions': 6}, {'tx': 11, 'success': 5, 'collisions': 6}, {'tx': 16, 'success': 8, 'collisions': 8}, {'tx': 11, 'success': 6, 'collisions': 5}, {'tx': 4, 'success': 0, 'collisions': 4}, {'tx': 5, 'success': 1, 'collisions': 4}, {'tx': 9, 'success': 3, 'collisions': 6}, {'tx': 10, 'success': 5, 'collisions': 5}, {'tx': 10, 'success': 4, 'collisions': 6}, {'tx': 14, 'success': 7, 'collisions': 7}, {'tx': 9, 'success': 4, 'collisions': 5}]"
73,20,74,209,81,128,0.6124401913875598,0.3875598086124402,0.5994,"[{'tx': 7, 'success': 3, 'collisions': 4}, {'tx': 6, 'success': 1, 'collisions': 5}, {'tx': 14, 'success': 7, 'collisions': 7}, {'tx': 8, 'success': 2, 'collisions': 6}, {'tx': 4, 'success': 0, 'collisions': 4}, {'tx': 5, 'success': 1, 'collisions': 4}, {'tx': 7, 'success': 1, 'collisions': 6}, {'tx': 9, 'success': 3, 'collisions': 6}, {'tx': 15, 'success': 5, 'collisions': 10}, {'tx': 11, 'success': 4, 'collisions': 7}, {'tx': 13, 'success': 4, 'collisions': 9}, {'tx': 16, 'success': 9, 'collisions': 7}, {'tx': 8, 'success': 1, 'collisions': 7}, {'tx': 7, 'success': 1, 'collisions': 6}, {'tx': 18, 'success': 12, 'collisions': 6}, {'tx': 10, 'success': 4, 'collisions': 6}, {'tx': 14, 'success': 6, 'collisions': 8}, {'tx': 11, 'success': 4, 'collisions': 7}, {'tx': 20, 'success': 12, 'collisions': 8}, {'tx': 6, 'success': 1, 'collisions': 5}]"
74,20,75,197,86,111,0.5634517766497462,0.4365482233502538,0.645,"[{'tx': 17, 'success': 12, 'collisions': 5}, {'tx': 8, 'success': 3, 'collisions': 5}, {'tx': 4, 'success': 0, 'collisions': 4}, {'tx': 11, 'success': 6, 'collisions': 5}, {'tx': 7, 'success': 3, 'collisions': 4}, {'tx': 14, 'success': 6, 'collisions': 8}, {'tx': 9, 'success': 2, 'collisions': 7}, {'tx': 11, 'success': 4, 'collisions': 7}, {'tx': 13, 'success': 5, 'collisions': 8}, {'tx': 4, 'success': 0, 'collisions': 4}, {'tx': 4, 'success': 0, 'collisions': 4}, {'tx': 11, 'success': 5, 'collisions': 6}, {'tx': 10, 'success': 4, 'collisions': 6}, {'tx': 8, 'success': 4, 'collisions': 4}, {'tx': 7, 'success': 2, 'collisions': 5}, {'tx': 9, 'success': 2, 'collisions': 7}, {'tx': 12, 'success': 7, 'collisions': 5}, {'tx': 10, 'success': 4, 'collisions': 6}, {'tx': 11, 'success': 6, 'collisions': 5}, {'tx': 17, 'success': 11, 'collisions': 6}]"
75,20,76,199,79,120,0.6030150753768844,0.3969849246231156,0.6004,"[{'tx': 4, 'success': 0, 'collisions': 4}, {'tx': 13, 'success': 6, 'collisions': 7}, {'tx': 9, 'success': 3, 'collisions': 6}, {'tx': 15, 'success': 10, 'collisions': 5}, {'tx': 8, 'success': 1, 'collisions': 7}, {'tx': 13, 'success': 4, 'collisions': 9}, {'tx': 15, 'success': 7, 'collisions': 8}, {'tx': 9, 'success': 3, 'collisions': 6}, {'tx': 17, 'success': 10, 'collisions': 7}, {'tx': 10, 'success': 4, 'collisions': 6}, {'tx': 9, 'success': 2, 'collisions': 7}, {'tx': 4, 'success': 0, 'collisions': 4}, {'tx': 11, 'success': 6, 'collisions': 5}, {'tx': 10, 'success': 5, 'collisions': 5}, {'tx': 4, 'success': 0, 'collisions': 4}, {'tx': 14, 'success': 6, 'collisions': 8}, {'tx': 11, 'success': 3, 'collisions': 8}, {'tx': 7, 'success': 2, 'collisions': 5}, {'tx': 12, 'success': 7, 'collisions': 5}, {'tx': 4, 'success': 0, 'collisions': 4}]"
76,20,77,201,78,123,0.6119402985074627,0.3880597014925373,0.6006,"[{'tx': 9, 'success': 3, 'collisions': 6}, {'tx': 4, 'success': 0, 'collisions': 4}, {'tx': 4, 'success': 0, 'collisions': 4}, {'tx': 4, 'success': 0, 'collisions': 4}, {'tx': 18, 'success': 9, 'collisions': 9}, {'tx': 9, 'success': 2, 'collisions': 7}, {'tx': 9, 'success': 3, 'collisions': 6}, {'tx': 11, 'success': 7, 'collisions': 4}, {'tx': 15, 'success': 9, 'collisions': 6}, {'tx': 12, 'success': 7, 'collisions': 5}, {'tx': 4, 'success': 0, 'collisions': 4}, {'tx': 13, 'success': 5, 'collisions': 8}, {'tx': 7, 'success': 2, 'collisions': 5}, {'tx': 12, 'success': 3, 'collisions': 9}, {'tx': 15, 'success': 9, 'collisions': 6}, {'tx': 13, 'success': 5, 'collisions': 8}, {'tx': 12, 'success': 6, 'collisions': 6}, {'tx': 7, 'success': 1, 'collisions': 6}, {'tx': 10, 'success': 3, 'collisions': 7}, {'tx': 13, 'success': 4, 'collisions': 9}]"
77,20,78,197,79,118,0.5989847715736041,0.4010152284263959,0.6162,"[{'tx': 19, 'success': 13, 'collisions': 6}, {'tx': 9, 'success': 3, 'collisions': 6}, {'tx': 4, 'success': 0, 'collisions': 4}, {'tx': 10, 'success': 3, 'collisions': 7}, {'tx': 9, 'success': 3, 'collisions': 6}, {'tx': 7, 'success': 2, 'collisions': 5}, {'tx': 3, 'success': 0, 'collisions': 3}, {'tx': 15, 'success': 7, 'collisions': 8}, {'tx': 5, 'success': 0, 'collisions': 5}, {'tx': 8, 'success': 3, 'collisions': 5}, {'tx': 10, 'success': 4, 'collisions': 6}, {'tx': 17, 'success': 10, 'collisions': 7}, {'tx': 13, 'success': 5, 'collisions': 8}, {'tx': 8, 'success': 2, 'collisions': 6}, {'tx': 13, 'success': 5, 'collisions': 8}, {'tx': 7, 'success': 2, 'collisions': 5}, {'tx': 7, 'success': 2, 'collisions': 5}, {'tx': 12, 'success': 6, 'collisions': 6}, {'tx': 6, 'success': 2, 'collisions': 4}, {'tx': 15, 'success': 7, 'collisions': 8}]"
78,20,79,205,75,130,0.6341463414634146,0.36585365853658536,0.5925,"[{'tx': 8, 'success': 2, 'collisions': 6}, {'tx': 4, 'success': 0, 'collisions': 4}, {'tx': 13, 'success': 7, 'collisions': 6}, {'tx': 8, 'success': 2, 'collisions': 6}, {'tx': 11, 'success': 4, 'collisions': 7}, {'tx': 12, 'success': 3, 'collisions': 9}, {'tx': 15, 'success': 5, 'collisions': 10}, {'tx': 7, 'success': 1, 'collisions': 6}, {'tx': 5, 'success': 1, 'collisions': 4}, {'tx': 5, 'success': 0, 'collisions': 5}, {'tx': 18, 'success': 12, 'collisions': 6}, {'tx': 20, 'success': 12, 'collisions': 8}, {'tx': 8, 'success': 2, 'collisions': 6}, {'tx': 10, 'success': 3, 'collisions': 7}, {'tx': 14, 'success': 6, 'collisions': 8}, {'tx': 6, 'success': 1, 'collisions': 5}, {'tx': 10, 'success': 4, 'collisions': 6}, {'tx': 9, 'success': 3, 'collisions': 6}, {'tx': 12, 'success': 5, 'collisions': 7}, {'tx': 10, 'success': 2, 'collisions': 8}]"
79,20,80,185,77,108,0.5837837837837838,0.41621621621621624,0.616,"[{'tx': 11, 'success': 3, 'collisions': 8}, {'tx': 5, 'success': 1, 'collisions': 4}, {'tx': 14, 'success': 8, 'collisions': 6}, {'tx': 8, 'success': 2, 'collisions': 6}, {'tx': 4, 'success': 0, 'collisions': 4}, {'tx': 4, 'success': 0, 'collisions': 4}, {'tx': 12, 'success': 6, 'collisions': 6}, {'tx': 10, 'success': 5, 'collisions': 5}, {'tx': 19, 'success': 13, 'collisions': 6}, {'tx': 12, 'success': 6, 'collisions': 6}, {'tx': 4, 'success': 0, 'collisions': 4}, {'tx': 5, 'success': 0, 'collisions': 5}, {'tx': 9, 'success': 4, 'collisions': 5}, {'tx': 8, 'success': 3, 'collisions': 5}, {'tx': 15, 'success': 7, 'collisions': 8}, {'tx': 9, 'success': 4, 'collisions': 5}, {'tx': 7, 'success': 1, 'collisions': 6}, {'tx': 9, 'success': 4, 'collisions': 5}, {'tx': 10, 'success': 6, 'collisions': 4}, {'tx': 10, 'success': 4, 'collisions': 6}]"
80,20,81,185,73,112,0.6054054054054054,0.3945945945945946,0.5913,"[{'tx': 12, 'success': 6, 'collisions': 6}, {'tx': 4, 'success': 0, 'collisions': 4}, {'tx': 9, 'success': 3, 'collisions': 6}, {'tx': 15, 'success': 9, 'collisions': 6}, {'tx': 7, 'success': 1, 'collisions': 6}, {'tx': 4, 'success': 0, 'collisions': 4}, {'tx': 9, 'success': 1, 'collisions': 8}, {'tx': 16, 'success': 9, 'collisions': 7}, {'tx': 7, 'success': 3, 'collisions': 4}, {'tx': 11, 'success': 5, 'collisions': 6}, {'tx': 15, 'success': 8, 'collisions': 7}, {'tx': 10, 'success': 3, 'collisions': 7}, {'tx': 15, 'success': 10, 'collisions': 5}, {'tx': 5, 'success': 0, 'collisions': 5}, {'tx': 11, 'success': 4, 'collisions': 7}, {'tx': 4, 'success': 0, 'collisions': 4}, {'tx': 4, 'success': 0, 'collisions': 4}, {'tx': 10, 'success': 3, 'collisions': 7}, {'tx': 4, 'success': 0, 'collisions': 4}, {'tx': 13, 'success': 8, 'collisions': 5}]"
81,20,82,192,72,120,0.625,0.375,0.5904,"[{'tx': 4, 'success': 0, 'collisions': 4}, {'tx': 15, 'success': 7, 'collisions': 8}, {'tx': 9, 'success': 2, 'collisions': 7}, {'tx': 8, 'success': 3, 'collisions': 5}, {'tx': 7, 'success': 2, 'collisions': 5}, {'tx': 4, 'success': 0, 'collisions': 4}, {'tx': 8, 'success': 2, 'collisions': 6}, {'tx': 18, 'success': 11, 'collisions': 7}, {'tx': 7, 'success': 1, 'collisions': 6}, {'tx': 4, 'success': 0, 'collisions': 4}, {'tx': 4, 'success': 0, 'collisions': 4}, {'tx': 7, 'success': 3, 'collisions': 4}, {'tx': 15, 'success': 5, 'collisions': 10}, {'tx': 7, 'success': 2, 'collisions': 5}, {'tx': 7, 'success': 2, 'collisions': 5}, {'tx': 14, 'success': 6, 'collisions': 8}, {'tx': 16, 'success': 8, 'collisions': 8}, {'tx': 8, 'success': 3, 'collisions': 5}, {'tx': 13, 'success': 5, 'collisions': 8}, {'tx': 17, 'success': 10, 'collisions': 7}]"
82,20,83,188,71,117,0.6223404255319149,0.3776595744680851,0.5893,"[{'tx': 12, 'success': 5, 'collisions': 7}, {'tx': 7, 'success': 1, 'collisions': 6}, {'tx': 4, 'success': 0, 'collisions': 4}, {'tx': 11, 'success': 5, 'collisions': 6}, {'tx': 4, 'success': 0, 'collisions': 4}, {'tx': 4, 'success': 0, 'collisions': 4}, {'tx': 14, 'success': 7, 'collisions': 7}, {'tx': 10, 'success': 4, 'collisions': 6}, {'tx': 14, 'success': 9, 'collisions': 5}, {'tx': 7, 'success': 2, 'collisions': 5}, {'tx': 12, 'success': 5, 'collisions': 7}, {'tx': 5, 'success': 0, 'collisions': 5}, {'tx': 15, 'success': 9, 'collisions': 6}, {'tx': 12, 'success': 5, 'collisions': 7}, {'tx': 4, 'success': 0, 'collisions': 4}, {'tx': 4, 'success': 0, 'collisions': 4}, {'tx': 8, 'success': 3, 'collisions': 5}, {'tx': 17, 'success': 6, 'collisions': 11}, {'tx': 10, 'success': 3, 'collisions': 7}, {'tx': 14, 'success': 7, 'collisions': 7}]"
83,20,84,189,71,118,0.6243386243386243,0.37566137566137564,0.5964,"[{'tx': 10, 'success': 4, 'collisions': 6}, {'tx': 6, 'success': 2, 'collisions': 4}, {'tx': 10, 'success': 3, 'collisions': 7}, {'tx': 4, 'success': 0, 'collisions': 4}, {'tx': 11, 'success': 4, 'collisions': 7}, {'tx': 10, 'success': 3, 'collisions': 7}, {'tx': 8, 'success': 3, 'collisions': 5}, {'tx': 11, 'success': 6, 'collisions': 5}, {'tx': 10, 'success': 4, 'collisions': 6}, {'tx': 14, 'success': 6, 'collisions': 8}, {'tx': 11, 'success': 5, 'collisions': 6}, {'tx': 7, 'success': 3, 'collisions': 4}, {'tx': 7, 'success': 2, 'collisions': 5}, {'tx': 13, 'success': 5, 'collisions': 8}, {'tx': 11, 'success': 5, 'collisions': 6}, {'tx': 13, 'success': 4, 'collisions': 9}, {'tx': 13, 'success': 6, 'collisions': 7}, {'tx': 7, 'success': 1, 'collisions': 6}, {'tx': 4, 'success': 0, 'collisions': 4}, {'tx': 9, 'success': 5, 'collisions': 4}]"
84,20,85,177,72,105,0.5932203389830508,0.4067796610169492,0.612,"[{'tx': 7, 'success': 2, 'collisions': 5}, {'tx': 13, 'success': 7, 'collisions': 6}, {'tx': 7, 'success': 1, 'collisions': 6}, {'tx': 9, 'success': 5, 'collisions': 4}, {'tx': 8, 'success': 2, 'collisions': 6}, {'tx': 8, 'success': 1, 'collisions': 7}, {'tx': 7, 'success': 2, 'collisions': 5}, {'tx': 9, 'success': 5, 'collisions': 4}, {'tx': 11, 'success': 6, 'collisions': 5}, {'tx': 13, 'success': 7, 'collisions': 6}, {'tx': 5, 'success': 2, 'collisions': 3}, {'tx': 12, 'success': 6, 'collisions': 6}, {'tx': 4, 'success': 0, 'collisions': 4}, {'tx': 10, 'success': 5, 'collisions': 5}, {'tx': 10, 'success': 5, 'collisions': 5}, {'tx': 7, 'success': 2, 'collisions': 5}, {'tx': 8, 'success': 2, 'collisions': 6}, {'tx': 10, 'success': 3, 'collisions': 7}, {'tx': 5, 'success': 1, 'collisions': 4}, {'tx': 14, 'success': 8, 'collisions': 6}]"
85,20,86,178,74,104,0.5842696629213483,0.4157303370786517,0.6364,"[{'tx': 3, 'success': 0, 'collisions': 3}, {'tx': 13, 'success': 6, 'collisions': 7}, {'tx': 4, 'success': 0, 'collisions': 4}, {'tx': 3, 'success': 0, 'collisions': 3}, {'tx': 20, 'success': 11, 'collisions': 9}, {'tx': 6, 'success': 1, 'collisions': 5}, {'tx': 7, 'success': 1, 'collisions': 6}, {'tx': 3, 'success': 0, 'collisions': 3}, {'tx': 13, 'success': 9, 'collisions': 4}, {'tx': 4, 'success': 1, 'collisions': 3}, {'tx': 7, 'success': 3, 'collisions': 4}, {'tx': 13, 'success': 7, 'collisions': 6}, {'tx': 10, 'success': 3, 'collisions': 7}, {'tx': 14, 'success': 10, 'collisions': 4}, {'tx': 13, 'success': 6, 'collisions': 7}, {'tx': 9, 'success': 2, 'collisions': 7}, {'tx': 13, 'success': 8, 'collisions': 5}, {'tx': 11, 'success': 3, 'collisions': 8}, {'tx': 3, 'success': 0, 'collisions': 3}, {'tx': 9, 'success': 3, 'collisions': 6}]"
86,20,87,179,69,110,0.6145251396648045,0.3854748603351955,0.6003,"[{'tx': 8, 'success': 4, 'collisions': 4}, {'tx': 9, 'success': 4, 'collisions': 5}, {'tx': 6, 'success': 1, 'collisions': 5}, {'tx': 10, 'success': 4, 'collisions': 6}, {'tx': 4, 'success': 0, 'collisions': 4}, {'tx': 17, 'success': 8, 'collisions': 9}, {'tx': 10, 'success': 4, 'collisions': 6}, {'tx': 9, 'success': 3, 'collisions': 6}, {'tx': 15, 'success': 10, 'collisions': 5}, {'tx': 6, 'success': 1, 'collisions': 5}, {'tx': 16, 'success': 9, 'collisions': 7}, {'tx': 3, 'success': 0, 'collisions': 3}, {'tx': 13, 'success': 5, 'collisions': 8}, {'tx': 6, 'success': 1, 'collisions': 5}, {'tx': 11, 'success': 4, 'collisions': 7}, {'tx': 4, 'success': 0, 'collisions': 4}, {'tx': 7, 'success': 2, 'collisions': 5}, {'tx': 9, 'success': 4, 'collisions': 5}, {'tx': 9, 'success': 3, 'collisions': 6}, {'tx': 7, 'success': 2, 'collisions': 5}]"
87,20,88,181,63,118,0.6519337016574586,0.34806629834254144,0.5544,"[{'tx': 15, 'success': 7, 'collisions': 8}, {'tx': 9, 'success': 2, 'collisions': 7}, {'tx': 8, 'success': 2, 'collisions': 6}, {'tx': 11, 'success': 6, 'collisions': 5}, {'tx': 9, 'success': 4, 'collisions': 5}, {'tx': 11, 'success': 5, 'collisions': 6}, {'tx': 9, 'success': 3, 'collisions': 6}, {'tx': 6, 'success': 1, 'collisions': 5}, {'tx': 4, 'success': 0, 'collisions': 4}, {'tx': 6, 'success': 0, 'collisions': 6}, {'tx': 15, 'success': 7, 'collisions': 8}, {'tx': 7, 'success': 2, 'collisions': 5}, {'tx': 7, 'success': 1, 'collisions': 6}, {'tx': 7, 'success': 2, 'collisions': 5}, {'tx': 15, 'success': 8, 'collisions': 7}, {'tx': 7, 'success': 2, 'collisions': 5}, {'tx': 5, 'success': 2, 'collisions': 3}, {'tx': 9, 'success': 3, 'collisions': 6}, {'tx': 12, 'success': 3, 'collisions': 9}, {'tx': 9, 'success': 3, 'collisions': 6}]"
88,20,89,184,67,117,0.6358695652173914,0.3641304347826087,0.5963,"[{'tx': 17, 'success': 11, 'collisions': 6}, {'tx': 12, 'success': 4, 'collisions': 8}, {'tx': 8, 'success': 4, 'collisions': 4}, {'tx': 11, 'success': 3, 'collisions': 8}, {'tx': 10, 'success': 3, 'collisions': 7}, {'tx': 6, 'success': 1, 'collisions': 5}, {'tx': 6, 'success': 1, 'collisions': 5}, {'tx': 11, 'success': 4, 'collisions': 7}, {'tx': 11, 'success': 5, 'collisions': 6}, {'tx': 5, 'success': 1, 'collisions': 4}, {'tx': 5, 'success': 1, 'collisions': 4}, {'tx': 10, 'success': 3, 'collisions': 7}, {'tx': 10, 'success': 5, 'collisions': 5}, {'tx': 5, 'success': 1, 'collisions': 4}, {'tx': 12, 'success': 5, 'collisions': 7}, {'tx': 6, 'success': 2, 'collisions': 4}, {'tx': 14, 'success': 7, 'collisions': 7}, {'tx': 8, 'success': 1, 'collisions': 7}, {'tx': 8, 'success': 3, 'collisions': 5}, {'tx': 9, 'success': 2, 'collisions': 7}]"
89,20,90,171,67,104,0.6081871345029239,0.391812865497076,0.603,"[{'tx': 6, 'success': 1, 'collisions': 5}, {'tx': 6, 'success': 1, 'collisions': 5}, {'tx': 8, 'success': 2, 'collisions': 6}, {'tx': 20, 'success': 12, 'collisions': 8}, {'tx': 6, 'success': 1, 'collisions': 5}, {'tx': 5, 'success': 1, 'collisions': 4}, {'tx': 7, 'success': 3, 'collisions': 4}, {'tx': 11, 'success': 6, 'collisions': 5}, {'tx': 10, 'success': 4, 'collisions': 6}, {'tx': 8, 'success': 3, 'collisions': 5}, {'tx': 4, 'success': 0, 'collisions': 4}, {'tx': 8, 'success': 3, 'collisions': 5}, {'tx': 8, 'success': 3, 'collisions': 5}, {'tx': 9, 'success': 4, 'collisions': 5}, {'tx': 5, 'success': 1, 'collisions': 4}, {'tx': 11, 'success': 4, 'collisions': 7}, {'tx': 12, 'success': 6, 'collisions': 6}, {'tx': 11, 'success': 5, 'collisions': 6}, {'tx': 10, 'success': 4, 'collisions': 6}, {'tx': 6, 'success': 3, 'collisions': 3}]"
90,20,91,167,69,98,0.5868263473053892,0.41317365269461076,0.6279,"[{'tx': 4, 'success': 0, 'collisions': 4}, {'tx': 16, 'success': 10, 'collisions': 6}, {'tx': 8, 'success': 3, 'collisions': 5}, {'tx': 4, 'success': 0, 'collisions': 4}, {'tx': 13, 'success': 6, 'collisions': 7}, {'tx': 11, 'success': 6, 'collisions': 5}, {'tx': 12, 'success': 7, 'collisions': 5}, {'tx': 5, 'success': 1, 'collisions': 4}, {'tx': 9, 'success': 4, 'collisions': 5}, {'tx': 6, 'success': 1, 'collisions': 5}, {'tx': 8, 'success': 3, 'collisions': 5}, {'tx': 3, 'success': 0, 'collisions': 3}, {'tx': 9, 'success': 6, 'collisions': 3}, {'tx': 12, 'success': 5, 'collisions': 7}, {'tx': 11, 'success': 4, 'collisions': 7}, {'tx': 5, 'success': 1, 'collisions': 4}, {'tx': 8, 'success': 3, 'collisions': 5}, {'tx': 7, 'success': 3, 'collisions': 4}, {'tx': 8, 'success': 3, 'collisions': 5}, {'tx': 8, 'success': 3, 'collisions': 5}]"
91,20,92,169,66,103,0.6094674556213018,0.3905325443786982,0.6072,"[{'tx': 8, 'success': 3, 'collisions': 5}, {'tx': 4, 'success': 0, 'collisions': 4}, {'tx': 11, 'success': 6, 'collisions': 5}, {'tx': 11, 'success': 5, 'collisions': 6}, {'tx': 10, 'success': 4, 'collisions': 6}, {'tx': 8, 'success': 1, 'collisions': 7}, {'tx': 7, 'success': 2, 'collisions': 5}, {'tx': 4, 'success': 0, 'collisions': 4}, {'tx': 7, 'success': 1, 'collisions': 6}, {'tx': 4, 'success': 0, 'collisions': 4}, {'tx': 6, 'success': 3, 'collisions': 3}, {'tx': 8, 'success': 2, 'collisions': 6}, {'tx': 9, 'success': 4, 'collisions': 5}, {'tx': 18, 'success': 11, 'collisions': 7}, {'tx': 15, 'success': 8, 'collisions': 7}, {'tx': 9, 'success': 5, 'collisions': 4}, {'tx': 11, 'success': 5, 'collisions': 6}, {'tx': 9, 'success': 5, 'collisions': 4}, {'tx': 6, 'success': 1, 'collisions': 5}, {'tx': 4, 'success': 0, 'collisions': 4}]"
92,20,93,165,67,98,0.593939393939394,0.40606060606060607,0.6231,"[{'tx': 9, 'success': 2, 'collisions': 7}, {'tx': 5, 'success': 2, 'collisions': 3}, {'tx': 3, 'success': 0, 'collisions': 3}, {'tx': 8, 'success': 3, 'collisions': 5}, {'tx': 4, 'success': 0, 'collisions': 4}, {'tx': 7, 'success': 2, 'collisions': 5}, {'tx': 13, 'success': 8, 'collisions': 5}, {'tx': 8, 'success': 3, 'collisions': 5}, {'tx': 9, 'success': 3, 'collisions': 6}, {'tx': 5, 'success': 1, 'collisions': 4}, {'tx': 13, 'success': 8, 'collisions': 5}, {'tx': 13, 'success': 6, 'collisions': 7}, {'tx': 9, 'success': 3, 'collisions': 6}, {'tx': 10, 'success': 5, 'collisions': 5}, {'tx': 6, 'success': 2, 'collisions': 4}, {'tx': 14, 'success': 9, 'collisions': 5}, {'tx': 10, 'success': 4, 'collisions': 6}, {'tx': 4, 'success': 1, 'collisions': 3}, {'tx': 8, 'success': 3, 'collisions': 5}, {'tx': 7, 'success': 2, 'collisions': 5}]"
93,20,94,166,65,101,0.608433734939759,0.39156626506024095,0.611,"[{'tx': 4, 'success': 1, 'collisions': 3}, {'tx': 7, 'success': 2, 'collisions': 5}, {'tx': 4, 'success': 0, 'collisions': 4}, {'tx': 13, 'success': 7, 'collisions': 6}, {'tx': 10, 'success': 5, 'collisions': 5}, {'tx': 12, 'success': 5, 'collisions': 7}, {'tx': 5, 'success': 1, 'collisions': 4}, {'tx': 4, 'success': 0, 'collisions': 4}, {'tx': 11, 'success': 4, 'collisions': 7}, {'tx': 4, 'success': 0, 'collisions': 4}, {'tx': 9, 'success': 4, 'collisions': 5}, {'tx': 9, 'success': 3, 'collisions': 6}, {'tx': 6, 'success': 2, 'collisions': 4}, {'tx': 14, 'success': 7, 'collisions': 7}, {'tx': 12, 'success': 7, 'collisions': 5}, {'tx': 7, 'success': 4, 'collisions': 3}, {'tx': 13, 'success': 5, 'collisions': 8}, {'tx': 9, 'success': 4, 'collisions': 5}, {'tx': 9, 'success': 4, 'collisions': 5}, {'tx': 4, 'success': 0, 'collisions': 4}]"
94,20,95,161,63,98,0.6086956521739131,0.391304347826087,0.5985,"[{'tx': 12, 'success': 6, 'collisions': 6}, {'tx': 9, 'success': 3, 'collisions': 6}, {'tx': 9, 'success': 3, 'collisions': 6}, {'tx': 8, 'success': 2, 'collisions': 6}, {'tx': 11, 'success': 6, 'collisions': 5}, {'tx': 5, 'success': 1, 'collisions': 4}, {'tx': 4, 'success': 0, 'collisions': 4}, {'tx': 9, 'success': 4, 'collisions': 5}, {'tx': 3, 'success': 0, 'collisions': 3}, {'tx': 9, 'success': 5, 'collisions': 4}, {'tx': 10, 'success': 5, 'collisions': 5}, {'tx': 10, 'success': 3, 'collisions': 7}, {'tx': 9, 'success': 4, 'collisions': 5}, {'tx': 13, 'success': 8, 'collisions': 5}, {'tx': 6, 'success': 1, 'collisions': 5}, {'tx': 5, 'success': 1, 'collisions': 4}, {'tx': 12, 'success': 6, 'collisions': 6}, {'tx': 5, 'success': 1, 'collisions': 4}, {'tx': 4, 'success': 1, 'collisions': 3}, {'tx': 8, 'success': 3, 'collisions': 5}]"
95,20,96,163,60,103,0.6319018404907976,0.36809815950920244,0.576,"[{'tx': 10, 'success': 5, 'collisions': 5}, {'tx': 12, 'success': 7, 'collisions': 5}, {'tx': 10, 'success': 5, 'collisions': 5}, {'tx': 10, 'success': 4, 'collisions': 6}, {'tx': 4, 'success': 0, 'collisions': 4}, {'tx': 14, 'success': 7, 'collisions': 7}, {'tx': 5, 'success': 2, 'collisions': 3}, {'tx': 15, 'success': 9, 'collisions': 6}, {'tx': 7, 'success': 2, 'collisions': 5}, {'tx': 4, 'success': 0, 'collisions': 4}, {'tx': 4, 'success': 0, 'collisions': 4}, {'tx': 4, 'success': 0, 'collisions': 4}, {'tx': 11, 'success': 3, 'collisions': 8}, {'tx': 12, 'success': 5, 'collisions': 7}, {'tx': 4, 'success': 0, 'collisions': 4}, {'tx': 11, 'success': 6, 'collisions': 5}, {'tx': 7, 'success': 1, 'collisions': 6}, {'tx': 9, 'success': 3, 'collisions': 6}, {'tx': 3, 'success': 0, 'collisions': 3}, {'tx': 7, 'success': 1, 'collisions': 6}]"
96,20,97,161,60,101,0.6273291925465838,0.37267080745341613,0.582,"[{'tx': 4, 'success': 1, 'collisions': 3}, {'tx': 3, 'success': 0, 'collisions': 3}, {'tx': 4, 'success': 1, 'collisions': 3}, {'tx': 12, 'success': 5, 'collisions': 7}, {'tx': 6, 'success': 2, 'collisions': 4}, {'tx': 3, 'success': 0, 'collisions': 3}, {'tx': 15, 'success': 9, 'collisions': 6}, {'tx': 8, 'success': 2, 'collisions': 6}, {'tx': 10, 'success': 3, 'collisions': 7}, {'tx': 14, 'success': 6, 'collisions': 8}, {'tx': 11, 'success': 7, 'collisions': 4}, {'tx': 4, 'success': 0, 'collisions': 4}, {'tx': 10, 'success': 3, 'collisions': 7}, {'tx': 7, 'success': 2, 'collisions': 5}, {'tx': 9, 'success': 3, 'collisions': 6}, {'tx': 5, 'success': 1, 'collisions': 4}, {'tx': 6, 'success': 2, 'collisions': 4}, {'tx': 10, 'success': 4, 'collisions': 6}, {'tx': 11, 'success': 5, 'collisions': 6}, {'tx': 9, 'success': 4, 'collisions': 5}]"
97,20,98,162,60,102,0.6296296296296297,0.37037037037037035,0.588,"[{'tx': 4, 'success': 0, 'collisions': 4}, {'tx': 7, 'success': 3, 'collisions': 4}, {'tx': 9, 'success': 3, 'collisions': 6}, {'tx': 7, 'success': 2, 'collisions': 5}, {'tx': 9, 'success': 3, 'collisions': 6}, {'tx': 9, 'success': 4, 'collisions': 5}, {'tx': 6, 'success': 1, 'collisions': 5}, {'tx': 9, 'success': 3, 'collisions': 6}, {'tx': 12, 'success': 5, 'collisions': 7}, {'tx': 10, 'success': 4, 'collisions': 6}, {'tx': 4, 'success': 0, 'collisions': 4}, {'tx': 6, 'success': 1, 'collisions': 5}, {'tx': 7, 'success': 1, 'collisions': 6}, {'tx': 12, 'success': 7, 'collisions': 5}, {'tx': 11, 'success': 6, 'collisions': 5}, {'tx': 7, 'success': 3, 'collisions': 4}, {'tx': 9, 'success': 3, 'collisions': 6}, {'tx': 7, 'success': 3, 'collisions': 4}, {'tx': 5, 'success': 1, 'collisions': 4}, {'tx': 12, 'success': 7, 'collisions': 5}]"
98,20,99,161,57,104,0.6459627329192547,0.35403726708074534,0.5643,"[{'tx': 7, 'success': 2, 'collisions': 5}, {'tx': 12, 'success': 6, 'collisions': 6}, {'tx': 12, 'success': 5, 'collisions': 7}, {'tx': 6, 'success': 1, 'collisions': 5}, {'tx': 5, 'success': 1, 'collisions': 4}, {'tx': 10, 'success': 4, 'collisions': 6}, {'tx': 7, 'success': 1, 'collisions': 6}, {'tx': 8, 'success': 4, 'collisions': 4}, {'tx': 4, 'success': 0, 'collisions': 4}, {'tx': 5, 'success': 1, 'collisions': 4}, {'tx': 10, 'success': 3, 'collisions': 7}, {'tx': 4, 'success': 0, 'collisions': 4}, {'tx': 12, 'success': 5, 'collisions': 7}, {'tx': 5, 'success': 1, 'collisions': 4}, {'tx': 7, 'success': 1, 'collisions': 6}, {'tx': 12, 'success': 5, 'collisions': 7}, {'tx': 9, 'success': 4, 'collisions': 5}, {'tx': 10, 'success': 4, 'collisions': 6}, {'tx': 4, 'success': 0, 'collisions': 4}, {'tx': 12, 'success': 9, 'collisions': 3}]"
99,20,100,162,57,105,0.6481481481481481,0.35185185185185186,0.57,"[{'tx': 19, 'success': 9, 'collisions': 10}, {'tx': 7, 'success': 2, 'collisions': 5}, {'tx': 10, 'success': 5, 'collisions': 5}, {'tx': 11, 'success': 5, 'collisions': 6}, {'tx': 4, 'success': 0, 'collisions': 4}, {'tx': 11, 'success': 5, 'collisions': 6}, {'tx': 14, 'success': 6, 'collisions': 8}, {'tx': 13, 'success': 6, 'collisions': 7}, {'tx': 3, 'success': 0, 'collisions': 3}, {'tx': 6, 'success': 1, 'collisions': 5}, {'tx': 5, 'success': 1, 'collisions': 4}, {'tx': 4, 'success': 0, 'collisions': 4}, {'tx': 6, 'success': 2, 'collisions': 4}, {'tx': 10, 'success': 4, 'collisions': 6}, {'tx': 12, 'success': 4, 'collisions': 8}, {'tx': 3, 'success': 0, 'collisions': 3}, {'tx': 8, 'success': 3, 'collisions': 5}, {'tx': 4, 'success': 0, 'collisions': 4}, {'tx': 3, 'success': 0, 'collisions': 3}, {'tx': 9, 'success': 4, 'collisions': 5}]"
100,30,1,7673,3589,4084,0.5322559624657891,0.46774403753421084,0.3589,"[{'tx': 397, 'success': 198, 'collisions': 199}, {'tx': 362, 'success': 188, 'collisions': 174}, {'tx': 223, 'success': 96, 'collisions': 127}, {'tx': 295, 'success': 138, 'collisions': 157}, {'tx': 301, 'success': 145, 'collisions': 156}, {'tx': 375, 'success': 179, 'collisions': 196}, {'tx': 322, 'success': 154, 'collisions': 168}, {'tx': 132, 'success': 54, 'collisions': 78}, {'tx': 271, 'success': 124, 'collisions': 147}, {'tx': 258, 'success': 121, 'collisions': 137}, {'tx': 148, 'success': 64, 'collisions': 84}, {'tx': 338, 'success': 152, 'collisions': 186}, {'tx': 250, 'success': 121, 'collisions': 129}, {'tx': 425, 'success': 209, 'collisions': 216}, {'tx': 186, 'success': 80, 'collisions': 106}, {'tx': 246, 'success': 112, 'collisions': 134}, {'tx': 106, 'success': 40, 'collisions': 66}, {'tx': 358, 'success': 170, 'collisions': 188}, {'tx': 172, 'success': 84, 'collisions': 88}, {'tx': 240, 'success': 105, 'collisions': 135}, {'tx': 226, 'success': 103, 'collisions': 123}, {'tx': 91, 'success': 42, 'collisions': 49}, {'tx': 266, 'success': 111, 'collisions': 155}, {'tx': 189, 'success': 91, 'collisions': 98}, {'tx': 131, 'success': 59, 'collisions': 72}, {'tx': 287, 'success': 147, 'collisions': 140}, {'tx': 299, 'success': 150, 'collisions': 149}, {'tx': 155, 'success': 59, 'collisions': 96}, {'tx': 405, 'success': 192, 'collisions': 213}, {'tx': 219, 'success': 101, 'collisions': 118}]"
101,30,2,4980,2350,2630,0.5281124497991968,0.4718875502008032,0.47,"[{'tx': 164, 'success': 77, 'collisions': 87}, {'tx': 169, 'success': 85, 'collisions': 84}, {'tx': 144, 'success': 55, 'collisions': 89}, {'tx': 256, 'success': 132, 'collisions': 124}, {'tx': 227, 'success': 118, 'collisions': 109}, {'tx': 189, 'success': 88, 'collisions': 101}, {'tx': 183, 'success': 80, 'collisions': 103}, {'tx': 29, 'success': 7, 'collisions': 22}, {'tx': 161, 'success': 75, 'collisions': 86}, {'tx': 189, 'success': 89, 'collisions': 100}, {'tx': 83, 'success': 33, 'collisions': 50}, {'tx': 253, 'success': 129, 'collisions': 124}, {'tx': 188, 'success': 87, 'collisions': 101}, {'tx': 164, 'success': 80, 'collisions': 84}, {'tx': 172, 'success': 83, 'collisions': 89}, {'tx': 115, 'success': 52, 'collisions': 63}, {'tx': 177, 'success': 84, 'collisions': 93}, {'tx': 77, 'success': 33, 'collisions': 44}, {'tx': 147, 'success': 75, 'collisions': 72}, {'tx': 101, 'success': 45, 'collisions': 56}, {'tx': 113, 'success': 52, 'collisions': 61}, {'tx': 285, 'success': 143, 'collisions': 142}, {'tx': 179, 'success': 82, 'collisions': 97}, {'tx': 241, 'success': 119, 'collisions': 122}, {'tx': 194, 'success': 96, 'collisions': 98}, {'tx': 159, 'success': 65, 'collisions': 94}, {'tx': 195, 'success': 94, 'collisions': 101}, {'tx': 137, 'success': 60, 'collisions': 77}, {'tx': 14, 'success': 2, 'collisions': 12}, {'tx': 275, 'success': 130, 'collisions': 145}]"
102,30,3,3678,1734,1944,0.5285481239804242,0.47145187601957583,0.5202,"[{'tx': 38, 'success': 16, 'collisions': 22}, {'tx': 70, 'success': 30, 'collisions': 40}, {'tx': 58, 'success': 23, 'collisions': 35}, {'tx': 62, 'success': 23, 'collisions': 39}, {'tx': 86, 'success': 41, 'collisions': 45}, {'tx': 130, 'success': 61, 'collisions': 69}, {'tx': 73, 'success': 28, 'collisions': 45}, {'tx': 122, 'success': 54, 'collisions': 68}, {'tx': 73, 'success': 33, 'collisions': 40}, {'tx': 137, 'success': 60, 'collisions': 77}, {'tx': 106, 'success': 45, 'collisions': 61}, {'tx': 176, 'success': 80, 'collisions': 96}, {'tx': 103, 'success': 49, 'collisions': 54}, {'tx': 128, 'success': 64, 'collisions': 64}, {'tx': 271, 'success': 143, 'collisions': 128}, {'tx': 55, 'success': 23, 'collisions': 32}, {'tx': 219, 'success': 110, 'collisions': 109}, {'tx': 111, 'success': 51, 'collisions': 60}, {'tx': 62, 'success': 26, 'collisions': 36}, {'tx': 130, 'success': 54, 'collisions': 76}, {'tx': 213, 'success': 114, 'collisions': 99}, {'tx': 255, 'success': 140, 'collisions': 115}, {'tx': 91, 'success': 41, 'collisions': 50}, {'tx': 35, 'success': 10, 'collisions': 25}, {'tx': 107, 'success': 54, 'collisions': 53}, {'tx': 185, 'success': 89, 'collisions': 96}, {'tx': 171, 'success': 77, 'collisions': 94}, {'tx': 89, 'success': 41, 'collisions': 48}, {'tx': 168, 'success': 79, 'collisions': 89}, {'tx': 154, 'success': 75, 'collisions': 79}]"
103,30,4,3034,1400,1634,0.5385629531970996,0.4614370468029005,0.56,"[{'tx': 76, 'success': 32, 'collisions': 44}, {'tx': 175, 'success': 92, 'collisions': 83}, {'tx': 104, 'success': 48, 'collisions': 56}, {'tx': 77, 'success': 28, 'collisions': 49}, {'tx': 66, 'success': 27, 'collisions': 39}, {'tx': 161, 'success': 74, 'collisions': 87}, {'tx': 114, 'success': 52, 'collisions': 62}, {'tx': 54, 'success': 19, 'collisions': 35}, {'tx': 129, 'success': 58, 'collisions': 71}, {'tx': 186, 'success': 89, 'collisions': 97}, {'tx': 169, 'success': 84, 'collisions': 85}, {'tx': 46, 'success': 20, 'collisions': 26}, {'tx': 128, 'success': 60, 'collisions': 68}, {'tx': 71, 'success': 33, 'collisions': 38}, {'tx': 143, 'success': 71, 'collisions': 72}, {'tx': 148, 'success': 73, 'collisions': 75}, {'tx': 112, 'success': 51, 'collisions': 61}, {'tx': 101, 'success': 43, 'collisions': 58}, {'tx': 86, 'success': 37, 'collisions': 49}, {'tx': 27, 'success': 11, 'collisions': 16}, {'tx': 23, 'success': 6, 'collisions': 17}, {'tx': 101, 'success': 49, 'collisions': 52}, {'tx': 141, 'success': 64, 'collisions': 77}, {'tx': 100, 'success': 46, 'collisions': 54}, {'tx': 32, 'success': 10, 'collisions': 22}, {'tx': 85, 'success': 39, 'collisions': 46}, {'tx': 38, 'success': 12, 'collisions': 26}, {'tx': 114, 'success': 53, 'collisions': 61}, {'tx': 119, 'success': 66, 'collisions': 53}, {'tx': 108, 'success': 53, 'collisions': 55}]"
104,30,5,2484,1142,1342,0.5402576489533011,0.45974235104669886,0.571,"[{'tx': 64, 'success': 28, 'collisions': 36}, {'tx': 141, 'success': 79, 'collisions': 62}, {'tx': 88, 'success': 41, 'collisions': 47}, {'tx': 113, 'success': 50, 'collisions': 63}, {'tx': 109, 'success': 52, 'collisions': 57}, {'tx': 98, 'success': 46, 'collisions': 52}, {'tx': 15, 'success': 2, 'collisions': 13}, {'tx': 95, 'success': 49, 'collisions': 46}, {'tx': 19, 'success': 5, 'collisions': 14}, {'tx': 117, 'success': 49, 'collisions': 68}, {'tx': 116, 'success': 57, 'collisions': 59}, {'tx': 124, 'success': 61, 'collisions': 63}, {'tx': 106, 'success': 51, 'collisions': 55}, {'tx': 86, 'success': 41, 'collisions': 45}, {'tx': 95, 'success': 44, 'collisions': 51}, {'tx': 19, 'success': 7, 'collisions': 12}, {'tx': 55, 'success': 21, 'collisions': 34}, {'tx': 35, 'success': 11, 'collisions': 24}, {'tx': 130, 'success': 60, 'collisions': 70}, {'tx': 39, 'success': 16, 'collisions': 23}, {'tx': 36, 'success': 12, 'collisions': 24}, {'tx': 24, 'success': 5, 'collisions': 19}, {'tx': 117, 'success': 54, 'collisions': 63}, {'tx': 122, 'success': 61, 'collisions': 61}, {'tx': 106, 'success': 52, 'collisions': 54}, {'tx': 86, 'success': 38, 'collisions': 48}, {'tx': 82, 'success': 40, 'collisions': 42}, {'tx': 87, 'success': 39, 'collisions': 48}, {'tx': 98, 'success': 47, 'collisions': 51}, {'tx': 62, 'success': 24, 'collisions': 38}]"
105,30,6,2182,973,1209,0.5540788267644363,0.4459211732355637,0.5838,"[{'tx': 45, 'success': 19, 'collisions': 26}, {'tx': 78, 'success': 33, 'collisions': 45}, {'tx': 55, 'success': 20, 'collisions': 35}, {'tx': 84, 'success': 41, 'collisions': 43}, {'tx': 106, 'success': 49, 'collisions': 57}, {'tx': 44, 'success': 15, 'collisions': 29}, {'tx': 43, 'success': 16, 'collisions': 27}, {'tx': 74, 'success': 32, 'collisions': 42}, {'tx': 30, 'success': 12, 'collisions': 18}, {'tx': 63, 'success': 21, 'collisions': 42}, {'tx': 43, 'success': 20, 'collisions': 23}, {'tx': 70, 'success': 30, 'collisions': 40}, {'tx': 94, 'success': 49, 'collisions': 45}, {'tx': 115, 'success': 51, 'collisions': 64}, {'tx': 84, 'success': 34, 'collisions': 50}, {'tx': 26, 'success': 7, 'collisions': 19}, {'tx': 82, 'success': 38, 'collisions': 44}, {'tx': 56, 'success': 24, 'collisions': 32}, {'tx': 99, 'success': 47, 'collisions': 52}, {'tx': 68, 'success': 29, 'collisions': 39}, {'tx': 124, 'success': 70, 'collisions': 54}, {'tx': 87, 'success': 39, 'collisions': 48}, {'tx': 88, 'success': 41, 'collisions': 47}, {'tx': 99, 'success': 44, 'collisions': 55}, {'tx': 120, 'success': 62, 'collisions': 58}, {'tx': 9, 'success': 0, 'collisions': 9}, {'tx': 35, 'success': 13, 'collisions': 22}, {'tx': 84, 'success': 36, 'collisions': 48}, {'tx': 113, 'success': 55, 'collisions': 58}, {'tx': 64, 'success': 26, 'collisions': 38}]"
106,30,7,1860,854,1006,0.5408602150537635,0.4591397849462366,0.5978,"[{'tx': 84, 'success': 39, 'collisions': 45}, {'tx': 84, 'success': 36, 'collisions': 48}, {'tx': 91, 'success': 41, 'collisions': 50}, {'tx': 129, 'success': 77, 'collisions': 52}, {'tx': 57, 'success': 26, 'collisions': 31}, {'tx': 55, 'success': 21, 'collisions': 34}, {'tx': 78, 'success': 39, 'collisions': 39}, {'tx': 20, 'success': 4, 'collisions': 16}, {'tx': 95, 'success': 42, 'collisions': 53}, {'tx': 44, 'success': 21, 'collisions': 23}, {'tx': 78, 'success': 37, 'collisions': 41}, {'tx': 105, 'success': 55, 'collisions': 50}, {'tx': 26, 'success': 9, 'collisions': 17}, {'tx': 37, 'success': 16, 'collisions': 21}, {'tx': 87, 'success': 39, 'collisions': 48}, {'tx': 49, 'success': 20, 'collisions': 29}, {'tx': 9, 'success': 0, 'collisions': 9}, {'tx': 17, 'success': 7, 'collisions': 10}, {'tx': 58, 'success': 27, 'collisions': 31}, {'tx': 62, 'success': 33, 'collisions': 29}, {'tx': 70, 'success': 28, 'collisions': 42}, {'tx': 34, 'success': 10, 'collisions': 24}, {'tx': 58, 'success': 30, 'collisions': 28}, {'tx': 63, 'success': 28, 'collisions': 35}, {'tx': 77, 'success': 36, 'collisions': 41}, {'tx': 58, 'success': 29, 'collisions': 29}, {'tx': 67, 'success': 31, 'collisions': 36}, {'tx': 115, 'success': 55, 'collisions': 60}, {'tx': 31, 'success': 11, 'collisions': 20}, {'tx': 22, 'success': 7, 'collisions': 15}]"
107,30,8,1636,728,908,0.5550122249388753,0.4449877750611247,0.5824,"[{'tx': 13, 'success': 3, 'collisions': 10}, {'tx': 67, 'success': 23, 'collisions': 44}, {'tx': 91, 'success': 49, 'collisions': 42}, {'tx': 112, 'success': 58, 'collisions': 54}, {'tx': 35, 'success': 12, 'collisions': 23}, {'tx': 96, 'success': 50, 'collisions': 46}, {'tx': 29, 'success': 9, 'collisions': 20}, {'tx': 74, 'success': 27, 'collisions': 47}, {'tx': 77, 'success': 38, 'collisions': 39}, {'tx': 105, 'success': 60, 'collisions': 45}, {'tx': 56, 'success': 26, 'collisions': 30}, {'tx': 47, 'success': 17, 'collisions': 30}, {'tx': 58, 'success': 29, 'collisions': 29}, {'tx': 77, 'success': 30, 'collisions': 47}, {'tx': 55, 'success': 25, 'collisions': 30}, {'tx': 77, 'success': 36, 'collisions': 41}, {'tx': 7, 'success': 0, 'collisions': 7}, {'tx': 38, 'success': 19, 'collisions': 19}, {'tx': 63, 'success': 27, 'collisions': 36}, {'tx': 48, 'success': 22, 'collisions': 26}, {'tx': 28, 'success': 10, 'collisions': 18}, {'tx': 70, 'success': 29, 'collisions': 41}, {'tx': 73, 'success': 33, 'collisions': 40}, {'tx': 38, 'success': 18, 'collisions': 20}, {'tx': 57, 'success': 24, 'collisions': 33}, {'tx': 85, 'success': 39, 'collisions': 46}, {'tx': 8, 'success': 0, 'collisions': 8}, {'tx': 9, 'success': 1, 'collisions': 8}, {'tx': 9, 'success': 1, 'collisions': 8}, {'tx': 34, 'success': 13, 'collisions': 21}]"
108,30,9,1528,670,858,0.5615183246073299,0.43848167539267013,0.603,"[{'tx': 37, 'success': 14, 'collisions': 23}, {'tx': 55, 'success': 24, 'collisions': 31}, {'tx': 53, 'success': 23, 'collisions': 30}, {'tx': 24, 'success': 10, 'collisions': 14}, {'tx': 47, 'success': 19, 'collisions': 28}, {'tx': 21, 'success': 5, 'collisions': 16}, {'tx': 67, 'success': 28, 'collisions': 39}, {'tx': 19, 'success': 4, 'collisions': 15}, {'tx': 32, 'success': 12, 'collisions': 20}, {'tx': 48, 'success': 21, 'collisions': 27}, {'tx': 49, 'success': 24, 'collisions': 25}, {'tx': 63, 'success': 29, 'collisions': 34}, {'tx': 95, 'success': 52, 'collisions': 43}, {'tx': 22, 'success': 5, 'collisions': 17}, {'tx': 81, 'success': 41, 'collisions': 40}, {'tx': 32, 'success': 10, 'collisions': 22}, {'tx': 41, 'success': 13, 'collisions': 28}, {'tx': 98, 'success': 57, 'collisions': 41}, {'tx': 46, 'success': 18, 'collisions': 28}, {'tx': 78, 'success': 39, 'collisions': 39}, {'tx': 12, 'success': 2, 'collisions': 10}, {'tx': 62, 'success': 26, 'collisions': 36}, {'tx': 60, 'success': 23, 'collisions': 37}, {'tx': 54, 'success': 21, 'collisions': 33}, {'tx': 28, 'success': 8, 'collisions': 20}, {'tx': 79, 'success': 34, 'collisions': 45}, {'tx': 70, 'success': 35, 'collisions': 35}, {'tx': 63, 'success': 31, 'collisions': 32}, {'tx': 66, 'success': 33, 'collisions': 33}, {'tx': 26, 'success': 9, 'collisions': 17}]"
109,30,10,1374,616,758,0.5516739446870451,0.4483260553129549,0.616,"[{'tx': 29, 'success': 12, 'collisions': 17}, {'tx': 70, 'success': 35, 'collisions': 35}, {'tx': 7, 'success': 0, 'collisions': 7}, {'tx': 47, 'success': 21, 'collisions': 26}, {'tx': 53, 'success': 24, 'collisions': 29}, {'tx': 75, 'success': 34, 'collisions': 41}, {'tx': 48, 'success': 22, 'collisions': 26}, {'tx': 85, 'success': 49, 'collisions': 36}, {'tx': 66, 'success': 27, 'collisions': 39}, {'tx': 44, 'success': 18, 'collisions': 26}, {'tx': 32, 'success': 10, 'collisions': 22}, {'tx': 16, 'success': 6, 'collisions': 10}, {'tx': 66, 'success': 28, 'collisions': 38}, {'tx': 104, 'success': 55, 'collisions': 49}, {'tx': 48, 'success': 19, 'collisions': 29}, {'tx': 45, 'success': 20, 'collisions': 25}, {'tx': 58, 'success': 23, 'collisions': 35}, {'tx': 70, 'success': 33, 'collisions': 37}, {'tx': 15, 'success': 4, 'collisions': 11}, {'tx': 10, 'success': 2, 'collisions': 8}, {'tx': 7, 'success': 0, 'collisions': 7}, {'tx': 73, 'success': 33, 'collisions': 40}, {'tx': 51, 'success': 25, 'collisions': 26}, {'tx': 59, 'success': 28, 'collisions': 31}, {'tx': 51, 'success': 27, 'collisions': 24}, {'tx': 7, 'success': 0, 'collisions': 7}, {'tx': 7, 'success': 0, 'collisions': 7}, {'tx': 47, 'success': 22, 'collisions': 25}, {'tx': 10, 'success': 1, 'collisions': 9}, {'tx': 74, 'success': 38, 'collisions': 36}]"
110,30,11,1234,548,686,0.5559157212317666,0.44408427876823336,0.6028,"[{'tx': 9, 'success': 1, 'collisions': 8}, {'tx': 29, 'success': 11, 'collisions': 18}, {'tx': 61, 'success': 33, 'collisions': 28}, {'tx': 47, 'success': 21, 'collisions': 26}, {'tx': 64, 'success': 32, 'collisions': 32}, {'tx': 64, 'success': 33, 'collisions': 31}, {'tx': 63, 'success': 32, 'collisions': 31}, {'tx': 67, 'success': 31, 'collisions': 36}, {'tx': 33, 'success': 16, 'collisions': 17}, {'tx': 26, 'success': 8, 'collisions': 18}, {'tx': 12, 'success': 2, 'collisions': 10}, {'tx': 35, 'success': 14, 'collisions': 21}, {'tx': 51, 'success': 25, 'collisions': 26}, {'tx': 13, 'success': 2, 'collisions': 11}, {'tx': 58, 'success': 25, 'collisions': 33}, {'tx': 78, 'success': 39, 'collisions': 39}, {'tx': 25, 'success': 10, 'collisions': 15}, {'tx': 20, 'success': 7, 'collisions': 13}, {'tx': 59, 'success': 28, 'collisions': 31}, {'tx': 62, 'success': 31, 'collisions': 31}, {'tx': 21, 'success': 9, 'collisions': 12}, {'tx': 18, 'success': 4, 'collisions': 14}, {'tx': 19, 'success': 5, 'collisions': 14}, {'tx': 26, 'success': 8, 'collisions': 18}, {'tx': 44, 'success': 17, 'collisions': 27}, {'tx': 65, 'success': 35, 'collisions': 30}, {'tx': 91, 'success': 47, 'collisions': 44}, {'tx': 38, 'success': 12, 'collisions': 26}, {'tx': 10, 'success': 1, 'collisions': 9}, {'tx': 26, 'success': 9, 'collisions': 17}]"
111,30,12,1192,505,687,0.5763422818791947,0.4236577181208054,0.606,"[{'tx': 24, 'success': 9, 'collisions': 15}, {'tx': 6, 'success': 0, 'collisions': 6}, {'tx': 50, 'success': 20, 'collisions': 30}, {'tx': 50, 'success': 23, 'collisions': 27}, {'tx': 66, 'success': 28, 'collisions': 38}, {'tx': 69, 'success': 37, 'collisions': 32}, {'tx': 29, 'success': 10, 'collisions': 19}, {'tx': 67, 'success': 30, 'collisions': 37}, {'tx': 18, 'success': 9, 'collisions': 9}, {'tx': 23, 'success': 6, 'collisions': 17}, {'tx': 8, 'success': 1, 'collisions': 7}, {'tx': 58, 'success': 27, 'collisions': 31}, {'tx': 59, 'success': 28, 'collisions': 31}, {'tx': 40, 'success': 17, 'collisions': 23}, {'tx': 55, 'success': 26, 'collisions': 29}, {'tx': 56, 'success': 24, 'collisions': 32}, {'tx': 30, 'success': 11, 'collisions': 19}, {'tx': 29, 'success': 10, 'collisions': 19}, {'tx': 29, 'success': 9, 'collisions': 20}, {'tx': 63, 'success': 30, 'collisions': 33}, {'tx': 29, 'success': 15, 'collisions': 14}, {'tx': 57, 'success': 25, 'collisions': 32}, {'tx': 6, 'success': 0, 'collisions': 6}, {'tx': 36, 'success': 15, 'collisions': 21}, {'tx': 26, 'success': 7, 'collisions': 19}, {'tx': 52, 'success': 23, 'collisions': 29}, {'tx': 43, 'success': 16, 'collisions': 27}, {'tx': 48, 'success': 20, 'collisions': 28}, {'tx': 12, 'success': 3, 'collisions': 9}, {'tx': 54, 'success': 26, 'collisions': 28}]"
112,30,13,1091,448,643,0.5893675527039414,0.4106324472960587,0.5824,"[{'tx': 8, 'success': 1, 'collisions': 7}, {'tx': 23, 'success': 9, 'collisions': 14}, {'tx': 46, 'success': 19, 'collisions': 27}, {'tx': 20, 'success': 7, 'collisions': 13}, {'tx': 12, 'success': 2, 'collisions': 10}, {'tx': 16, 'success': 4, 'collisions': 12}, {'tx': 26, 'success': 9, 'collisions': 17}, {'tx': 19, 'success': 4, 'collisions': 15}, {'tx': 24, 'success': 6, 'collisions': 18}, {'tx': 72, 'success': 38, 'collisions': 34}, {'tx': 45, 'success': 19, 'collisions': 26}, {'tx': 39, 'success': 18, 'collisions': 21}, {'tx': 53, 'success': 22, 'collisions': 31}, {'tx': 15, 'success': 4, 'collisions': 11}, {'tx': 22, 'success': 6, 'collisions': 16}, {'tx': 69, 'success': 37, 'collisions': 32}, {'tx': 51, 'success': 22, 'collisions': 29}, {'tx': 24, 'success': 6, 'collisions': 18}, {'tx': 65, 'success': 28, 'collisions': 37}, {'tx': 47, 'success': 23, 'collisions': 24}, {'tx': 72, 'success': 35, 'collisions': 37}, {'tx': 20, 'success': 5, 'collisions': 15}, {'tx': 21, 'success': 9, 'collisions': 12}, {'tx': 22, 'success': 7, 'collisions': 15}, {'tx': 55, 'success': 24, 'collisions': 31}, {'tx': 45, 'success': 20, 'collisions': 25}, {'tx': 61, 'success': 30, 'collisions': 31}, {'tx': 38, 'success': 15, 'collisions': 23}, {'tx': 25, 'success': 8, 'collisions': 17}, {'tx': 36, 'success': 11, 'collisions': 25}]"
113,30,14,1016,430,586,0.5767716535433071,0.42322834645669294,0.602,"[{'tx': 67, 'success': 37, 'collisions': 30}, {'tx': 25, 'success': 9, 'collisions': 16}, {'tx': 19, 'success': 3, 'collisions': 16}, {'tx': 31, 'success': 12, 'collisions': 19}, {'tx': 62, 'success': 32, 'collisions': 30}, {'tx': 28, 'success': 9, 'collisions': 19}, {'tx': 46, 'success': 22, 'collisions': 24}, {'tx': 28, 'success': 10, 'collisions': 18}, {'tx': 61, 'success': 34, 'collisions': 27}, {'tx': 24, 'success': 6, 'collisions': 18}, {'tx': 44, 'success': 20, 'collisions': 24}, {'tx': 6, 'success': 0, 'collisions': 6}, {'tx': 6, 'success': 0, 'collisions': 6}, {'tx': 44, 'success': 15, 'collisions': 29}, {'tx': 38, 'success': 17, 'collisions': 21}, {'tx': 26, 'success': 11, 'collisions': 15}, {'tx': 58, 'success': 26, 'collisions': 32}, {'tx': 65, 'success': 31, 'collisions': 34}, {'tx': 19, 'success': 6, 'collisions': 13}, {'tx': 31, 'success': 12, 'collisions': 19}, {'tx': 79, 'success': 43, 'collisions': 36}, {'tx': 57, 'success': 26, 'collisions': 31}, {'tx': 35, 'success': 15, 'collisions': 20}, {'tx': 37, 'success': 14, 'collisions': 23}, {'tx': 6, 'success': 0, 'collisions': 6}, {'tx': 30, 'success': 11, 'collisions': 19}, {'tx': 15, 'success': 4, 'collisions': 11}, {'tx': 12, 'success': 3, 'collisions': 9}, {'tx': 11, 'success': 2, 'collisions': 9}, {'tx': 6, 'success': 0, 'collisions': 6}]"
114,30,15,966,403,563,0.582815734989648,0.41718426501035194,0.6045,"[{'tx': 36, 'success': 15, 'collisions': 21}, {'tx': 27, 'success': 7, 'collisions': 20}, {'tx': 30, 'success': 10, 'collisions': 20}, {'tx': 59, 'success': 28, 'collisions': 31}, {'tx': 28, 'success': 11, 'collisions': 17}, {'tx': 24, 'success': 11, 'collisions': 13}, {'tx': 55, 'success': 27, 'collisions': 28}, {'tx': 38, 'success': 15, 'collisions': 23}, {'tx': 28, 'success': 8, 'collisions': 20}, {'tx': 28, 'success': 8, 'collisions': 20}, {'tx': 32, 'success': 13, 'collisions': 19}, {'tx': 45, 'success': 21, 'collisions': 24}, {'tx': 17, 'success': 6, 'collisions': 11}, {'tx': 11, 'success': 1, 'collisions': 10}, {'tx': 10, 'success': 3, 'collisions': 7}, {'tx': 35, 'success': 14, 'collisions': 21}, {'tx': 42, 'success': 19, 'collisions': 23}, {'tx': 26, 'success': 8, 'collisions': 18}, {'tx': 44, 'success': 20, 'collisions': 24}, {'tx': 51, 'success': 22, 'collisions': 29}, {'tx': 8, 'success': 1, 'collisions': 7}, {'tx': 19, 'success': 5, 'collisions': 14}, {'tx': 12, 'success': 2, 'collisions': 10}, {'tx': 61, 'success': 37, 'collisions': 24}, {'tx': 59, 'success': 34, 'collisions': 25}, {'tx': 26, 'success': 13, 'collisions': 13}, {'tx': 22, 'success': 9, 'collisions': 13}, {'tx': 29, 'success': 9, 'collisions': 20}, {'tx': 40, 'success': 19, 'collisions': 21}, {'tx': 24, 'success': 7, 'collisions': 17}]"
115,30,16,897,373,524,0.5841694537346711,0.4158305462653289,0.5968,"[{'tx': 42, 'success': 18, 'collisions': 24}, {'tx': 38, 'success': 14, 'collisions': 24}, {'tx': 32, 'success': 14, 'collisions': 18}, {'tx': 32, 'success': 16, 'collisions': 16}, {'tx': 17, 'success': 5, 'collisions': 12}, {'tx': 35, 'success': 20, 'collisions': 15}, {'tx': 35, 'success': 15, 'collisions': 20}, {'tx': 54, 'success': 27, 'collisions': 27}, {'tx': 37, 'success': 15, 'collisions': 22}, {'tx': 43, 'success': 22, 'collisions': 21}, {'tx': 7, 'success': 0, 'collisions': 7}, {'tx': 13, 'success': 3, 'collisions': 10}, {'tx': 9, 'success': 1, 'collisions': 8}, {'tx': 47, 'success': 22, 'collisions': 25}, {'tx': 37, 'success': 15, 'collisions': 22}, {'tx': 19, 'success': 5, 'collisions': 14}, {'tx': 6, 'success': 0, 'collisions': 6}, {'tx': 46, 'success': 25, 'collisions': 21}, {'tx': 7, 'success': 0, 'collisions': 7}, {'tx': 12, 'success': 1, 'collisions': 11}, {'tx': 29, 'success': 13, 'collisions': 16}, {'tx': 26, 'success': 9, 'collisions': 17}, {'tx': 33, 'success': 12, 'collisions': 21}, {'tx': 51, 'success': 21, 'collisions': 30}, {'tx': 40, 'success': 18, 'collisions': 22}, {'tx': 31, 'success': 12, 'collisions': 19}, {'tx': 48, 'success': 26, 'collisions': 22}, {'tx': 30, 'success': 11, 'collisions': 19}, {'tx': 34, 'success': 12, 'collisions': 22}, {'tx': 7, 'success': 1, 'collisions': 6}]"
116,30,17,855,342,513,0.6,0.4,0.5814,"[{'tx': 34, 'success': 14, 'collisions': 20}, {'tx': 6, 'success': 0, 'collisions': 6}, {'tx': 46, 'success': 23, 'collisions': 23}, {'tx': 27, 'success': 10, 'collisions': 17}, {'tx': 44, 'success': 19, 'collisions': 25}, {'tx': 9, 'success': 2, 'collisions': 7}, {'tx': 21, 'success': 5, 'collisions': 16}, {'tx': 8, 'success': 1, 'collisions': 7}, {'tx': 53, 'success': 25, 'collisions': 28}, {'tx': 42, 'success': 22, 'collisions': 20}, {'tx': 24, 'success': 9, 'collisions': 15}, {'tx': 23, 'success': 6, 'collisions': 17}, {'tx': 25, 'success': 8, 'collisions': 17}, {'tx': 20, 'success': 8, 'collisions': 12}, {'tx': 16, 'success': 5, 'collisions': 11}, {'tx': 37, 'success': 11, 'collisions': 26}, {'tx': 15, 'success': 5, 'collisions': 10}, {'tx': 18, 'success': 6, 'collisions': 12}, {'tx': 31, 'success': 14, 'collisions': 17}, {'tx': 46, 'success': 19, 'collisions': 27}, {'tx': 16, 'success': 5, 'collisions': 11}, {'tx': 26, 'success': 9, 'collisions': 17}, {'tx': 49, 'success': 21, 'collisions': 28}, {'tx': 6, 'success': 0, 'collisions': 6}, {'tx': 19, 'success': 7, 'collisions': 12}, {'tx': 31, 'success': 9, 'collisions': 22}, {'tx': 61, 'success': 35, 'collisions': 26}, {'tx': 39, 'success': 17, 'collisions': 22}, {'tx': 24, 'success': 10, 'collisions': 14}, {'tx': 39, 'success': 17, 'collisions': 22}]"
117,30,18,827,323,504,0.6094316807738815,0.3905683192261185,0.5814,"[{'tx': 17, 'success': 4, 'collisions': 13}, {'tx': 49, 'success': 24, 'collisions': 25}, {'tx': 12, 'success': 2, 'collisions': 10}, {'tx': 26, 'success': 9, 'collisions': 17}, {'tx': 15, 'success': 3, 'collisions': 12}, {'tx': 36, 'success': 17, 'collisions': 19}, {'tx': 31, 'success': 15, 'collisions': 16}, {'tx': 38, 'success': 12, 'collisions': 26}, {'tx': 26, 'success': 10, 'collisions': 16}, {'tx': 19, 'success': 7, 'collisions': 12}, {'tx': 18, 'success': 4, 'collisions': 14}, {'tx': 12, 'success': 4, 'collisions': 8}, {'tx': 34, 'success': 12, 'collisions': 22}, {'tx': 38, 'success': 18, 'collisions': 20}, {'tx': 24, 'success': 9, 'collisions': 15}, {'tx': 9, 'success': 1, 'collisions': 8}, {'tx': 14, 'success': 5, 'collisions': 9}, {'tx': 22, 'success': 5, 'collisions': 17}, {'tx': 25, 'success': 9, 'collisions': 16}, {'tx': 35, 'success': 15, 'collisions': 20}, {'tx': 12, 'success': 2, 'collisions': 10}, {'tx': 43, 'success': 19, 'collisions': 24}, {'tx': 51, 'success': 25, 'collisions': 26}, {'tx': 16, 'success': 5, 'collisions': 11}, {'tx': 25, 'success': 7, 'collisions': 18}, {'tx': 32, 'success': 13, 'collisions': 19}, {'tx': 52, 'success': 26, 'collisions': 26}, {'tx': 35, 'success': 16, 'collisions': 19}, {'tx': 21, 'success': 7, 'collisions': 14}, {'tx': 40, 'success': 18, 'collisions': 22}]"
118,30,19,773,305,468,0.6054333764553687,0.3945666235446313,0.5795,"[{'tx': 38, 'success': 16, 'collisions': 22}, {'tx': 31, 'success': 12, 'collisions': 19}, {'tx': 7, 'success': 1, 'collisions': 6}, {'tx': 24, 'success': 8, 'collisions': 16}, {'tx': 29, 'success': 12, 'collisions': 17}, {'tx': 6, 'success': 0, 'collisions': 6}, {'tx': 34, 'success': 16, 'collisions': 18}, {'tx': 6, 'success': 0, 'collisions': 6}, {'tx': 40, 'success': 17, 'collisions': 23}, {'tx': 19, 'success': 7, 'collisions': 12}, {'tx': 6, 'success': 0, 'collisions': 6}, {'tx': 34, 'success': 10, 'collisions': 24}, {'tx': 7, 'success': 0, 'collisions': 7}, {'tx': 36, 'success': 21, 'collisions': 15}, {'tx': 44, 'success': 20, 'collisions': 24}, {'tx': 9, 'success': 1, 'collisions': 8}, {'tx': 37, 'success': 15, 'collisions': 22}, {'tx': 41, 'success': 19, 'collisions': 22}, {'tx': 9, 'success': 2, 'collisions': 7}, {'tx': 39, 'success': 19, 'collisions': 20}, {'tx': 30, 'success': 14, 'collisions': 16}, {'tx': 40, 'success': 18, 'collisions': 22}, {'tx': 25, 'success': 9, 'collisions': 16}, {'tx': 18, 'success': 6, 'collisions': 12}, {'tx': 6, 'success': 0, 'collisions': 6}, {'tx': 39, 'success': 16, 'collisions': 23}, {'tx': 44, 'success': 21, 'collisions': 23}, {'tx': 52, 'success': 21, 'collisions': 31}, {'tx': 6, 'success': 0, 'collisions': 6}, {'tx': 17, 'success': 4, 'collisions': 13}]"
119,30,20,736,295,441,0.5991847826086957,0.4008152173913043,0.59,"[{'tx': 31, 'success': 13, 'collisions': 18}, {'tx': 19, 'success': 7, 'collisions': 12}, {'tx': 28, 'success': 11, 'collisions': 17}, {'tx': 22, 'success': 7, 'collisions': 15}, {'tx': 13, 'success': 2, 'collisions': 11}, {'tx': 29, 'success': 11, 'collisions': 18}, {'tx': 39, 'success': 19, 'collisions': 20}, {'tx': 48, 'success': 26, 'collisions': 22}, {'tx': 42, 'success': 20, 'collisions': 22}, {'tx': 36, 'success': 15, 'collisions': 21}, {'tx': 26, 'success': 9, 'collisions': 17}, {'tx': 16, 'success': 3, 'collisions': 13}, {'tx': 10, 'success': 1, 'collisions': 9}, {'tx': 35, 'success': 16, 'collisions': 19}, {'tx': 17, 'success': 5, 'collisions': 12}, {'tx': 34, 'success': 15, 'collisions': 19}, {'tx': 6, 'success': 0, 'collisions': 6}, {'tx': 6, 'success': 0, 'collisions': 6}, {'tx': 6, 'success': 0, 'collisions': 6}, {'tx': 25, 'success': 12, 'collisions': 13}, {'tx': 33, 'success': 17, 'collisions': 16}, {'tx': 49, 'success': 26, 'collisions': 23}, {'tx': 9, 'success': 1, 'collisions': 8}, {'tx': 19, 'success': 6, 'collisions': 13}, {'tx': 34, 'success': 17, 'collisions': 17}, {'tx': 16, 'success': 5, 'collisions': 11}, {'tx': 40, 'success': 17, 'collisions': 23}, {'tx': 36, 'success': 14, 'collisions': 22}, {'tx': 6, 'success': 0, 'collisions': 6}, {'tx': 6, 'success': 0, 'collisions': 6}]"
120,30,21,711,278,433,0.6090014064697609,0.3909985935302391,0.5838,"[{'tx': 25, 'success': 12, 'collisions': 13}, {'tx': 11, 'success': 4, 'collisions': 7}, {'tx': 32, 'success': 13, 'collisions': 19}, {'tx': 26, 'success': 9, 'collisions': 17}, {'tx': 10, 'success': 1, 'collisions': 9}, {'tx': 19, 'success': 7, 'collisions': 12}, {'tx': 12, 'success': 2, 'collisions': 10}, {'tx': 7, 'success': 0, 'collisions': 7}, {'tx': 10, 'success': 1, 'collisions': 9}, {'tx': 39, 'success': 22, 'collisions': 17}, {'tx': 9, 'success': 1, 'collisions': 8}, {'tx': 46, 'success': 19, 'collisions': 27}, {'tx': 11, 'success': 4, 'collisions': 7}, {'tx': 36, 'success': 17, 'collisions': 19}, {'tx': 31, 'success': 10, 'collisions': 21}, {'tx': 41, 'success': 19, 'collisions': 22}, {'tx': 29, 'success': 13, 'collisions': 16}, {'tx': 30, 'success': 11, 'collisions': 19}, {'tx': 8, 'success': 1, 'collisions': 7}, {'tx': 17, 'success': 7, 'collisions': 10}, {'tx': 16, 'success': 4, 'collisions': 12}, {'tx': 24, 'success': 11, 'collisions': 13}, {'tx': 12, 'success': 3, 'collisions': 9}, {'tx': 26, 'success': 9, 'collisions': 17}, {'tx': 30, 'success': 13, 'collisions': 17}, {'tx': 20, 'success': 8, 'collisions': 12}, {'tx': 37, 'success': 13, 'collisions': 24}, {'tx': 16, 'success': 4, 'collisions': 12}, {'tx': 44, 'success': 19, 'collisions': 25}, {'tx': 37, 'success': 21, 'collisions': 16}]"
121,30,22,680,268,412,0.6058823529411764,0.3941176470588235,0.5896,"[{'tx': 45, 'success': 24, 'collisions': 21}, {'tx': 8, 'success': 1, 'collisions': 7}, {'tx': 16, 'success': 5, 'collisions': 11}, {'tx': 22, 'success': 6, 'collisions': 16}, {'tx': 16, 'success': 5, 'collisions': 11}, {'tx': 18, 'success': 5, 'collisions': 13}, {'tx': 26, 'success': 11, 'collisions': 15}, {'tx': 23, 'success': 11, 'collisions': 12}, {'tx': 15, 'success': 3, 'collisions': 12}, {'tx': 20, 'success': 9, 'collisions': 11}, {'tx': 32, 'success': 14, 'collisions': 18}, {'tx': 22, 'success': 7, 'collisions': 15}, {'tx': 20, 'success': 5, 'collisions': 15}, {'tx': 37, 'success': 17, 'collisions': 20}, {'tx': 29, 'success': 14, 'collisions': 15}, {'tx': 10, 'success': 2, 'collisions': 8}, {'tx': 21, 'success': 8, 'collisions': 13}, {'tx': 43, 'success': 22, 'collisions': 21}, {'tx': 6, 'success': 0, 'collisions': 6}, {'tx': 36, 'success': 16, 'collisions': 20}, {'tx': 29, 'success': 12, 'collisions': 17}, {'tx': 16, 'success': 4, 'collisions': 12}, {'tx': 20, 'success': 6, 'collisions': 14}, {'tx': 21, 'success': 9, 'collisions': 12}, {'tx': 12, 'success': 3, 'collisions': 9}, {'tx': 27, 'success': 12, 'collisions': 15}, {'tx': 8, 'success': 1, 'collisions': 7}, {'tx': 43, 'success': 22, 'collisions': 21}, {'tx': 16, 'success': 4, 'collisions': 12}, {'tx': 23, 'success': 10, 'collisions': 13}]"
122,30,23,654,257,397,0.6070336391437309,0.3929663608562691,0.5911,"[{'tx': 26, 'success': 10, 'collisions': 16}, {'tx': 31, 'success': 13, 'collisions': 18}, {'tx': 6, 'success': 0, 'collisions': 6}, {'tx': 5, 'success': 0, 'collisions': 5}, {'tx': 6, 'success': 0, 'collisions': 6}, {'tx': 5, 'success': 0, 'collisions': 5}, {'tx': 29, 'success': 11, 'collisions': 18}, {'tx': 29, 'success': 12, 'collisions': 17}, {'tx': 33, 'success': 13, 'collisions': 20}, {'tx': 33, 'success': 11, 'collisions': 22}, {'tx': 25, 'success': 13, 'collisions': 12}, {'tx': 36, 'success': 16, 'collisions': 20}, {'tx': 16, 'success': 5, 'collisions': 11}, {'tx': 10, 'success': 1, 'collisions': 9}, {'tx': 6, 'success': 0, 'collisions': 6}, {'tx': 33, 'success': 13, 'collisions': 20}, {'tx': 7, 'success': 1, 'collisions': 6}, {'tx': 27, 'success': 11, 'collisions': 16}, {'tx': 16, 'success': 6, 'collisions': 10}, {'tx': 43, 'success': 27, 'collisions': 16}, {'tx': 6, 'success': 0, 'collisions': 6}, {'tx': 31, 'success': 15, 'collisions': 16}, {'tx': 30, 'success': 15, 'collisions': 15}, {'tx': 18, 'success': 6, 'collisions': 12}, {'tx': 16, 'success': 4, 'collisions': 12}, {'tx': 5, 'success': 0, 'collisions': 5}, {'tx': 36, 'success': 17, 'collisions': 19}, {'tx': 40, 'success': 16, 'collisions': 24}, {'tx': 17, 'success': 5, 'collisions': 12}, {'tx': 33, 'success': 16, 'collisions': 17}]"
123,30,24,630,247,383,0.6079365079365079,0.39206349206349206,0.5928,"[{'tx': 24, 'success': 9, 'collisions': 15}, {'tx': 33, 'success': 16, 'collisions': 17}, {'tx': 6, 'success': 0, 'collisions': 6}, {'tx': 13, 'success': 3, 'collisions': 10}, {'tx': 20, 'success': 7, 'collisions': 13}, {'tx': 19, 'success': 8, 'collisions': 11}, {'tx': 46, 'success': 24, 'collisions': 22}, {'tx': 6, 'success': 0, 'collisions': 6}, {'tx': 20, 'success': 7, 'collisions': 13}, {'tx': 37, 'success': 18, 'collisions': 19}, {'tx': 8, 'success': 1, 'collisions': 7}, {'tx': 30, 'success': 11, 'collisions': 19}, {'tx': 26, 'success': 12, 'collisions': 14}, {'tx': 15, 'success': 3, 'collisions': 12}, {'tx': 12, 'success': 2, 'collisions': 10}, {'tx': 18, 'success': 6, 'collisions': 12}, {'tx': 16, 'success': 7, 'collisions': 9}, {'tx': 6, 'success': 0, 'collisions': 6}, {'tx': 19, 'success': 6, 'collisions': 13}, {'tx': 17, 'success': 7, 'collisions': 10}, {'tx': 37, 'success': 20, 'collisions': 17}, {'tx': 28, 'success': 14, 'collisions': 14}, {'tx': 40, 'success': 20, 'collisions': 20}, {'tx': 28, 'success': 10, 'collisions': 18}, {'tx': 28, 'success': 13, 'collisions': 15}, {'tx': 6, 'success': 0, 'collisions': 6}, {'tx': 26, 'success': 10, 'collisions': 16}, {'tx': 16, 'success': 3, 'collisions': 13}, {'tx': 25, 'success': 10, 'collisions': 15}, {'tx': 5, 'success': 0, 'collisions': 5}]"
124,30,25,607,231,376,0.6194398682042833,0.3805601317957166,0.5775,"[{'tx': 16, 'success': 5, 'collisions': 11}, {'tx': 34, 'success': 14, 'collisions': 20}, {'tx': 5, 'success': 0, 'collisions': 5}, {'tx': 20, 'success': 8, 'collisions': 12}, {'tx': 7, 'success': 1, 'collisions': 6}, {'tx': 6, 'success': 0, 'collisions': 6}, {'tx': 33, 'success': 16, 'collisions': 17}, {'tx': 29, 'success': 11, 'collisions': 18}, {'tx': 31, 'success': 12, 'collisions': 19}, {'tx': 14, 'success': 4, 'collisions': 10}, {'tx': 19, 'success': 6, 'collisions': 13}, {'tx': 22, 'success': 8, 'collisions': 14}, {'tx': 32, 'success': 16, 'collisions': 16}, {'tx': 11, 'success': 3, 'collisions': 8}, {'tx': 20, 'success': 7, 'collisions': 13}, {'tx': 21, 'success': 9, 'collisions': 12}, {'tx': 5, 'success': 0, 'collisions': 5}, {'tx': 6, 'success': 0, 'collisions': 6}, {'tx': 30, 'success': 12, 'collisions': 18}, {'tx': 13, 'success': 2, 'collisions': 11}, {'tx': 31, 'success': 15, 'collisions': 16}, {'tx': 33, 'success': 14, 'collisions': 19}, {'tx': 37, 'success': 21, 'collisions': 16}, {'tx': 22, 'success': 8, 'collisions': 14}, {'tx': 29, 'success': 14, 'collisions': 15}, {'tx': 19, 'success': 3, 'collisions': 16}, {'tx': 28, 'success': 15, 'collisions': 13}, {'tx': 6, 'success': 0, 'collisions': 6}, {'tx': 5, 'success': 0, 'collisions': 5}, {'tx': 23, 'success': 7, 'collisions': 16}]"
125,30,26,595,220,375,0.6302521008403361,0.3697478991596639,0.572,"[{'tx': 36, 'success': 17, 'collisions': 19}, {'tx': 33, 'success': 19, 'collisions': 14}, {'tx': 28, 'success': 10, 'collisions': 18}, {'tx': 35, 'success': 19, 'collisions': 16}, {'tx': 14, 'success': 3, 'collisions': 11}, {'tx': 19, 'success': 6, 'collisions': 13}, {'tx': 37, 'success': 16, 'collisions': 21}, {'tx': 25, 'success': 8, 'collisions': 17}, {'tx': 5, 'success': 0, 'collisions': 5}, {'tx': 9, 'success': 2, 'collisions': 7}, {'tx': 16, 'success': 6, 'collisions': 10}, {'tx': 20, 'success': 8, 'collisions': 12}, {'tx': 20, 'success': 6, 'collisions': 14}, {'tx': 10, 'success': 3, 'collisions': 7}, {'tx': 17, 'success': 6, 'collisions': 11}, {'tx': 11, 'success': 4, 'collisions': 7}, {'tx': 13, 'success': 2, 'collisions': 11}, {'tx': 35, 'success': 18, 'collisions': 17}, {'tx': 15, 'success': 3, 'collisions': 12}, {'tx': 26, 'success': 14, 'collisions': 12}, {'tx': 14, 'success': 3, 'collisions': 11}, {'tx': 16, 'success': 3, 'collisions': 13}, {'tx': 12, 'success': 3, 'collisions': 9}, {'tx': 36, 'success': 14, 'collisions': 22}, {'tx': 16, 'success': 5, 'collisions': 11}, {'tx': 15, 'success': 4, 'collisions': 11}, {'tx': 29, 'success': 11, 'collisions': 18}, {'tx': 7, 'success': 1, 'collisions': 6}, {'tx': 18, 'success': 5, 'collisions': 13}, {'tx': 8, 'success': 1, 'collisions': 7}]"
126,30,27,563,212,351,0.6234458259325044,0.3765541740674956,0.5724,"[{'tx': 5, 'success': 0, 'collisions': 5}, {'tx': 34, 'success': 17, 'collisions': 17}, {'tx': 25, 'success': 8, 'collisions': 17}, {'tx': 6, 'success': 0, 'collisions': 6}, {'tx': 28, 'success': 16, 'collisions': 12}, {'tx': 7, 'success': 0, 'collisions': 7}, {'tx': 37, 'success': 21, 'collisions': 16}, {'tx': 17, 'success': 4, 'collisions': 13}, {'tx': 29, 'success': 12, 'collisions': 17}, {'tx': 22, 'success': 7, 'collisions': 15}, {'tx': 23, 'success': 9, 'collisions': 14}, {'tx': 5, 'success': 0, 'collisions': 5}, {'tx': 15, 'success': 5, 'collisions': 10}, {'tx': 28, 'success': 12, 'collisions': 16}, {'tx': 5, 'success': 0, 'collisions': 5}, {'tx': 36, 'success': 19, 'collisions': 17}, {'tx': 10, 'success': 1, 'collisions': 9}, {'tx': 20, 'success': 7, 'collisions': 13}, {'tx': 8, 'success': 1, 'collisions': 7}, {'tx': 24, 'success': 8, 'collisions': 16}, {'tx': 36, 'success': 17, 'collisions': 19}, {'tx': 17, 'success': 5, 'collisions': 12}, {'tx': 20, 'success': 7, 'collisions': 13}, {'tx': 16, 'success': 6, 'collisions': 10}, {'tx': 9, 'success': 2, 'collisions': 7}, {'tx': 18, 'success': 8, 'collisions': 10}, {'tx': 16, 'success': 5, 'collisions': 11}, {'tx': 19, 'success': 6, 'collisions': 13}, {'tx': 12, 'success': 4, 'collisions': 8}, {'tx': 16, 'success': 5, 'collisions': 11}]"
127,30,28,555,194,361,0.6504504504504505,0.34954954954954953,0.5432,"[{'tx': 5, 'success': 0, 'collisions': 5}, {'tx': 5, 'success': 0, 'collisions': 5}, {'tx': 14, 'success': 3, 'collisions': 11}, {'tx': 20, 'success': 6, 'collisions': 14}, {'tx': 18, 'success': 4, 'collisions': 14}, {'tx': 17, 'success': 5, 'collisions': 12}, {'tx': 19, 'success': 7, 'collisions': 12}, {'tx': 13, 'success': 3, 'collisions': 10}, {'tx': 12, 'success': 3, 'collisions': 9}, {'tx': 31, 'success': 15, 'collisions': 16}, {'tx': 25, 'success': 8, 'collisions': 17}, {'tx': 23, 'success': 10, 'collisions': 13}, {'tx': 26, 'success': 11, 'collisions': 15}, {'tx': 23, 'success': 9, 'collisions': 14}, {'tx': 22, 'success': 7, 'collisions': 15}, {'tx': 6, 'success': 0, 'collisions': 6}, {'tx': 24, 'success': 12, 'collisions': 12}, {'tx': 24, 'success': 10, 'collisions': 14}, {'tx': 37, 'success': 16, 'collisions': 21}, {'tx': 30, 'success': 12, 'collisions': 18}, {'tx': 9, 'success': 1, 'collisions': 8}, {'tx': 24, 'success': 9, 'collisions': 15}, {'tx': 21, 'success': 7, 'collisions': 14}, {'tx': 17, 'success': 5, 'collisions': 12}, {'tx': 14, 'success': 5, 'collisions': 9}, {'tx': 6, 'success': 1, 'collisions': 5}, {'tx': 25, 'success': 11, 'collisions': 14}, {'tx': 8, 'success': 2, 'collisions': 6}, {'tx': 17, 'success': 5, 'collisions': 12}, {'tx': 20, 'success': 7, 'collisions': 13}]"
128,30,29,524,203,321,0.6125954198473282,0.38740458015267176,0.5887,"[{'tx': 30, 'success': 15, 'collisions': 15}, {'tx': 6, 'success': 1, 'collisions': 5}, {'tx': 14, 'success': 3, 'collisions': 11}, {'tx': 7, 'success': 1, 'collisions': 6}, {'tx': 17, 'success': 5, 'collisions': 12}, {'tx': 11, 'success': 3, 'collisions': 8}, {'tx': 28, 'success': 16, 'collisions': 12}, {'tx': 6, 'success': 0, 'collisions': 6}, {'tx': 18, 'success': 6, 'collisions': 12}, {'tx': 23, 'success': 8, 'collisions': 15}, {'tx': 36, 'success': 20, 'collisions': 16}, {'tx': 17, 'success': 10, 'collisions': 7}, {'tx': 5, 'success': 0, 'collisions': 5}, {'tx': 10, 'success': 2, 'collisions': 8}, {'tx': 7, 'success': 2, 'collisions': 5}, {'tx': 26, 'success': 9, 'collisions': 17}, {'tx': 27, 'success': 13, 'collisions': 14}, {'tx': 12, 'success': 3, 'collisions': 9}, {'tx': 14, 'success': 3, 'collisions': 11}, {'tx': 15, 'success': 6, 'collisions': 9}, {'tx': 6, 'success': 0, 'collisions': 6}, {'tx': 19, 'success': 8, 'collisions': 11}, {'tx': 32, 'success': 17, 'collisions': 15}, {'tx': 12, 'success': 3, 'collisions': 9}, {'tx': 24, 'success': 9, 'collisions': 15}, {'tx': 15, 'success': 5, 'collisions': 10}, {'tx': 8, 'success': 2, 'collisions': 6}, {'tx': 35, 'success': 15, 'collisions': 20}, {'tx': 38, 'success': 18, 'collisions': 20}, {'tx': 6, 'success': 0, 'collisions': 6}]"
129,30,30,517,198,319,0.6170212765957447,0.3829787234042553,0.594,"[{'tx': 10, 'success': 3, 'collisions': 7}, {'tx': 25, 'success': 9, 'collisions': 16}, {'tx': 24, 'success': 10, 'collisions': 14}, {'tx': 9, 'success': 3, 'collisions': 6}, {'tx': 13, 'success': 2, 'collisions': 11}, {'tx': 23, 'success': 9, 'collisions': 14}, {'tx': 8, 'success': 1, 'collisions': 7}, {'tx': 5, 'success': 0, 'collisions': 5}, {'tx': 28, 'success': 15, 'collisions': 13}, {'tx': 26, 'success': 11, 'collisions': 15}, {'tx': 29, 'success': 14, 'collisions': 15}, {'tx': 12, 'success': 5, 'collisions': 7}, {'tx': 10, 'success': 2, 'collisions': 8}, {'tx': 7, 'success': 1, 'collisions': 6}, {'tx': 30, 'success': 14, 'collisions': 16}, {'tx': 22, 'success': 8, 'collisions': 14}, {'tx': 5, 'success': 0, 'collisions': 5}, {'tx': 6, 'success': 0, 'collisions': 6}, {'tx': 27, 'success': 15, 'collisions': 12}, {'tx': 11, 'success': 2, 'collisions': 9}, {'tx': 5, 'success': 0, 'collisions': 5}, {'tx': 24, 'success': 10, 'collisions': 14}, {'tx': 39, 'success': 21, 'collisions': 18}, {'tx': 28, 'success': 13, 'collisions': 15}, {'tx': 5, 'success': 0, 'collisions': 5}, {'tx': 5, 'success': 0, 'collisions': 5}, {'tx': 20, 'success': 7, 'collisions': 13}, {'tx': 17, 'success': 4, 'collisions': 13}, {'tx': 24, 'success': 8, 'collisions': 16}, {'tx': 20, 'success': 11, 'collisions': 9}]"
130,30,31,503,188,315,0.6262425447316103,0.37375745526838966,0.5828,"[{'tx': 24, 'success': 10, 'collisions': 14}, {'tx': 18, 'success': 5, 'collisions': 13}, {'tx': 8, 'success': 1, 'collisions': 7}, {'tx': 9, 'success': 1, 'collisions': 8}, {'tx': 24, 'success': 12, 'collisions': 12}, {'tx': 11, 'success': 4, 'collisions': 7}, {'tx': 21, 'success': 7, 'collisions': 14}, {'tx': 5, 'success': 0, 'collisions': 5}, {'tx': 5, 'success': 0, 'collisions': 5}, {'tx': 9, 'success': 2, 'collisions': 7}, {'tx': 29, 'success': 14, 'collisions': 15}, {'tx': 23, 'success': 11, 'collisions': 12}, {'tx': 20, 'success': 7, 'collisions': 13}, {'tx': 21, 'success': 6, 'collisions': 15}, {'tx': 29, 'success': 13, 'collisions': 16}, {'tx': 30, 'success': 14, 'collisions': 16}, {'tx': 9, 'success': 1, 'collisions': 8}, {'tx': 7, 'success': 1, 'collisions': 6}, {'tx': 22, 'success': 8, 'collisions': 14}, {'tx': 5, 'success': 0, 'collisions': 5}, {'tx': 23, 'success': 11, 'collisions': 12}, {'tx': 10, 'success': 2, 'collisions': 8}, {'tx': 35, 'success': 20, 'collisions': 15}, {'tx': 16, 'success': 5, 'collisions': 11}, {'tx': 5, 'success': 0, 'collisions': 5}, {'tx': 12, 'success': 4, 'collisions': 8}, {'tx': 25, 'success': 10, 'collisions': 15}, {'tx': 18, 'success': 8, 'collisions': 10}, {'tx': 5, 'success': 0, 'collisions': 5}, {'tx': 25, 'success': 11, 'collisions': 14}]"
131,30,32,483,187,296,0.6128364389233955,0.38716356107660455,0.5984,"[{'tx': 15, 'success': 6, 'collisions': 9}, {'tx': 24, 'success': 12, 'collisions': 12}, {'tx': 29, 'success': 14, 'collisions': 15}, {'tx': 18, 'success': 5, 'collisions': 13}, {'tx': 25, 'success': 9, 'collisions': 16}, {'tx': 11, 'success': 4, 'collisions': 7}, {'tx': 5, 'success': 0, 'collisions': 5}, {'tx': 5, 'success': 0, 'collisions': 5}, {'tx': 13, 'success': 2, 'collisions': 11}, {'tx': 27, 'success': 13, 'collisions': 14}, {'tx': 14, 'success': 4, 'collisions': 10}, {'tx': 5, 'success': 0, 'collisions': 5}, {'tx': 25, 'success': 13, 'collisions': 12}, {'tx': 18, 'success': 7, 'collisions': 11}, {'tx': 33, 'success': 17, 'collisions': 16}, {'tx': 6, 'success': 0, 'collisions': 6}, {'tx': 18, 'success': 7, 'collisions': 11}, {'tx': 20, 'success': 9, 'collisions': 11}, {'tx': 14, 'success': 7, 'collisions': 7}, {'tx': 23, 'success': 9, 'collisions': 14}, {'tx': 12, 'success': 2, 'collisions': 10}, {'tx': 8, 'success': 1, 'collisions': 7}, {'tx': 5, 'success': 0, 'collisions': 5}, {'tx': 20, 'success': 8, 'collisions': 12}, {'tx': 12, 'success': 5, 'collisions': 7}, {'tx': 5, 'success': 0, 'collisions': 5}, {'tx': 12, 'success': 4, 'collisions': 8}, {'tx': 15, 'success': 6, 'collisions': 9}, {'tx': 12, 'success': 3, 'collisions': 9}, {'tx': 34, 'success': 20, 'collisions': 14}]"
132,30,33,478,178,300,0.6276150627615062,0.3723849372384937,0.5874,"[{'tx': 20, 'success': 9, 'collisions': 11}, {'tx': 22, 'success': 10, 'collisions': 12}, {'tx': 9, 'success': 2, 'collisions': 7}, {'tx': 6, 'success': 0, 'collisions': 6}, {'tx': 13, 'success': 3, 'collisions': 10}, {'tx': 27, 'success': 13, 'collisions': 14}, {'tx': 22, 'success': 10, 'collisions': 12}, {'tx': 5, 'success': 0, 'collisions': 5}, {'tx': 9, 'success': 3, 'collisions': 6}, {'tx': 24, 'success': 9, 'collisions': 15}, {'tx': 13, 'success': 4, 'collisions': 9}, {'tx': 22, 'success': 7, 'collisions': 15}, {'tx': 5, 'success': 0, 'collisions': 5}, {'tx': 8, 'success': 1, 'collisions': 7}, {'tx': 12, 'success': 3, 'collisions': 9}, {'tx': 5, 'success': 0, 'collisions': 5}, {'tx': 26, 'success': 14, 'collisions': 12}, {'tx': 17, 'success': 9, 'collisions': 8}, {'tx': 16, 'success': 6, 'collisions': 10}, {'tx': 14, 'success': 4, 'collisions': 10}, {'tx': 23, 'success': 8, 'collisions': 15}, {'tx': 6, 'success': 0, 'collisions': 6}, {'tx': 5, 'success': 0, 'collisions': 5}, {'tx': 18, 'success': 7, 'collisions': 11}, {'tx': 17, 'success': 5, 'collisions': 12}, {'tx': 14, 'success': 3, 'collisions': 11}, {'tx': 34, 'success': 19, 'collisions': 15}, {'tx': 40, 'success': 20, 'collisions': 20}, {'tx': 18, 'success': 8, 'collisions': 10}, {'tx': 8, 'success': 1, 'collisions': 7}]"
133,30,34,467,169,298,0.6381156316916489,0.3618843683083512,0.5746,"[{'tx': 15, 'success': 5, 'collisions': 10}, {'tx': 5, 'success': 0, 'collisions': 5}, {'tx': 5, 'success': 0, 'collisions': 5}, {'tx': 16, 'success': 5, 'collisions': 11}, {'tx': 11, 'success': 2, 'collisions': 9}, {'tx': 14, 'success': 4, 'collisions': 10}, {'tx': 30, 'success': 16, 'collisions': 14}, {'tx': 11, 'success': 2, 'collisions': 9}, {'tx': 5, 'success': 0, 'collisions': 5}, {'tx': 15, 'success': 5, 'collisions': 10}, {'tx': 7, 'success': 0, 'collisions': 7}, {'tx': 12, 'success': 3, 'collisions': 9}, {'tx': 19, 'success': 6, 'collisions': 13}, {'tx': 26, 'success': 13, 'collisions': 13}, {'tx': 11, 'success': 4, 'collisions': 7}, {'tx': 18, 'success': 7, 'collisions': 11}, {'tx': 17, 'success': 6, 'collisions': 11}, {'tx': 13, 'success': 2, 'collisions': 11}, {'tx': 13, 'success': 5, 'collisions': 8}, {'tx': 29, 'success': 16, 'collisions': 13}, {'tx': 28, 'success': 11, 'collisions': 17}, {'tx': 6, 'success': 1, 'collisions': 5}, {'tx': 18, 'success': 6, 'collisions': 12}, {'tx': 24, 'success': 12, 'collisions': 12}, {'tx': 28, 'success': 16, 'collisions': 12}, {'tx': 5, 'success': 0, 'collisions': 5}, {'tx': 26, 'success': 10, 'collisions': 16}, {'tx': 10, 'success': 2, 'collisions': 8}, {'tx': 16, 'success': 5, 'collisions': 11}, {'tx': 14, 'success': 5, 'collisions': 9}]"
134,30,35,454,166,288,0.6343612334801763,0.3656387665198238,0.581,"[{'tx': 19, 'success': 7, 'collisions': 12}, {'tx': 19, 'success': 9, 'collisions': 10}, {'tx': 12, 'success': 3, 'collisions': 9}, {'tx': 17, 'success': 6, 'collisions': 11}, {'tx': 24, 'success': 11, 'collisions': 13}, {'tx': 14, 'success': 7, 'collisions': 7}, {'tx': 38, 'success': 20, 'collisions': 18}, {'tx': 13, 'success': 4, 'collisions': 9}, {'tx': 9, 'success': 2, 'collisions': 7}, {'tx': 17, 'success': 7, 'collisions': 10}, {'tx': 8, 'success': 2, 'collisions': 6}, {'tx': 19, 'success': 6, 'collisions': 13}, {'tx': 6, 'success': 0, 'collisions': 6}, {'tx': 10, 'success': 1, 'collisions': 9}, {'tx': 5, 'success': 0, 'collisions': 5}, {'tx': 8, 'success': 1, 'collisions': 7}, {'tx': 22, 'success': 9, 'collisions': 13}, {'tx': 24, 'success': 12, 'collisions': 12}, {'tx': 27, 'success': 14, 'collisions': 13}, {'tx': 14, 'success': 4, 'collisions': 10}, {'tx': 5, 'success': 0, 'collisions': 5}, {'tx': 25, 'success': 11, 'collisions': 14}, {'tx': 18, 'success': 6, 'collisions': 12}, {'tx': 8, 'success': 1, 'collisions': 7}, {'tx': 19, 'success': 6, 'collisions': 13}, {'tx': 6, 'success': 0, 'collisions': 6}, {'tx': 5, 'success': 0, 'collisions': 5}, {'tx': 14, 'success': 4, 'collisions': 10}, {'tx': 5, 'success': 0, 'collisions': 5}, {'tx': 24, 'success': 13, 'collisions': 11}]"
135,30,36,428,161,267,0.6238317757009346,0.37616822429906543,0.5796,"[{'tx': 20, 'success': 9, 'collisions': 11}, {'tx': 16, 'success': 5, 'collisions': 11}, {'tx': 11, 'success': 2, 'collisions': 9}, {'tx': 5, 'success': 0, 'collisions': 5}, {'tx': 32, 'success': 17, 'collisions': 15}, {'tx': 6, 'success': 0, 'collisions': 6}, {'tx': 17, 'success': 7, 'collisions': 10}, {'tx': 15, 'success': 5, 'collisions': 10}, {'tx': 15, 'success': 5, 'collisions': 10}, {'tx': 14, 'success': 3, 'collisions': 11}, {'tx': 9, 'success': 1, 'collisions': 8}, {'tx': 12, 'success': 3, 'collisions': 9}, {'tx': 7, 'success': 0, 'collisions': 7}, {'tx': 33, 'success': 19, 'collisions': 14}, {'tx': 19, 'success': 8, 'collisions': 11}, {'tx': 15, 'success': 7, 'collisions': 8}, {'tx': 16, 'success': 6, 'collisions': 10}, {'tx': 17, 'success': 6, 'collisions': 11}, {'tx': 27, 'success': 14, 'collisions': 13}, {'tx': 7, 'success': 1, 'collisions': 6}, {'tx': 29, 'success': 17, 'collisions': 12}, {'tx': 8, 'success': 3, 'collisions': 5}, {'tx': 5, 'success': 0, 'collisions': 5}, {'tx': 23, 'success': 11, 'collisions': 12}, {'tx': 7, 'success': 1, 'collisions': 6}, {'tx': 6, 'success': 0, 'collisions': 6}, {'tx': 5, 'success': 0, 'collisions': 5}, {'tx': 9, 'success': 2, 'collisions': 7}, {'tx': 18, 'success': 9, 'collisions': 9}, {'tx': 5, 'success': 0, 'collisions': 5}]"
136,30,37,439,156,283,0.6446469248291572,0.3553530751708428,0.5772,"[{'tx': 16, 'success': 5, 'collisions': 11}, {'tx': 18, 'success': 9, 'collisions': 9}, {'tx': 36, 'success': 20, 'collisions': 16}, {'tx': 15, 'success': 7, 'collisions': 8}, {'tx': 12, 'success': 3, 'collisions': 9}, {'tx': 7, 'success': 2, 'collisions': 5}, {'tx': 10, 'success': 3, 'collisions': 7}, {'tx': 17, 'success': 6, 'collisions': 11}, {'tx': 13, 'success': 3, 'collisions': 10}, {'tx': 18, 'success': 8, 'collisions': 10}, {'tx': 13, 'success': 5, 'collisions': 8}, {'tx': 5, 'success': 0, 'collisions': 5}, {'tx': 19, 'success': 8, 'collisions': 11}, {'tx': 8, 'success': 1, 'collisions': 7}, {'tx': 18, 'success': 7, 'collisions': 11}, {'tx': 13, 'success': 4, 'collisions': 9}, {'tx': 8, 'success': 1, 'collisions': 7}, {'tx': 16, 'success': 5, 'collisions': 11}, {'tx': 25, 'success': 11, 'collisions': 14}, {'tx': 13, 'success': 3, 'collisions': 10}, {'tx': 5, 'success': 0, 'collisions': 5}, {'tx': 10, 'success': 1, 'collisions': 9}, {'tx': 5, 'success': 0, 'collisions': 5}, {'tx': 33, 'success': 14, 'collisions': 19}, {'tx': 20, 'success': 10, 'collisions': 10}, {'tx': 9, 'success': 3, 'collisions': 6}, {'tx': 17, 'success': 6, 'collisions': 11}, {'tx': 9, 'success': 1, 'collisions': 8}, {'tx': 13, 'success': 4, 'collisions': 9}, {'tx': 18, 'success': 6, 'collisions': 12}]"
137,30,38,432,150,282,0.6527777777777778,0.3472222222222222,0.57,"[{'tx': 19, 'success': 8, 'collisions': 11}, {'tx': 24, 'success': 9, 'collisions': 15}, {'tx': 22, 'success': 8, 'collisions': 14}, {'tx': 5, 'success': 0, 'collisions': 5}, {'tx': 15, 'success': 6, 'collisions': 9}, {'tx': 23, 'success': 11, 'collisions': 12}, {'tx': 24, 'success': 12, 'collisions': 12}, {'tx': 14, 'success': 3, 'collisions': 11}, {'tx': 6, 'success': 1, 'collisions': 5}, {'tx': 16, 'success': 7, 'collisions': 9}, {'tx': 21, 'success': 10, 'collisions': 11}, {'tx': 14, 'success': 4, 'collisions': 10}, {'tx': 10, 'success': 2, 'collisions': 8}, {'tx': 25, 'success': 13, 'collisions': 12}, {'tx': 11, 'success': 3, 'collisions': 8}, {'tx': 12, 'success': 2, 'collisions': 10}, {'tx': 15, 'success': 5, 'collisions': 10}, {'tx': 7, 'success': 1, 'collisions': 6}, {'tx': 9, 'success': 1, 'collisions': 8}, {'tx': 5, 'success': 0, 'collisions': 5}, {'tx': 13, 'success': 4, 'collisions': 9}, {'tx': 5, 'success': 0, 'collisions': 5}, {'tx': 11, 'success': 3, 'collisions': 8}, {'tx': 18, 'success': 7, 'collisions': 11}, {'tx': 19, 'success': 8, 'collisions': 11}, {'tx': 14, 'success': 5, 'collisions': 9}, {'tx': 14, 'success': 3, 'collisions': 11}, {'tx': 7, 'success': 0, 'collisions': 7}, {'tx': 21, 'success': 10, 'collisions': 11}, {'tx': 13, 'success': 4, 'collisions': 9}]"
138,30,39,413,141,272,0.6585956416464891,0.3414043583535109,0.5499,"[{'tx': 6, 'success': 0, 'collisions': 6}, {'tx': 11, 'success': 4, 'collisions': 7}, {'tx': 13, 'success': 4, 'collisions': 9}, {'tx': 25, 'success': 10, 'collisions': 15}, {'tx': 7, 'success': 1, 'collisions': 6}, {'tx': 15, 'success': 5, 'collisions': 10}, {'tx': 15, 'success': 5, 'collisions': 10}, {'tx': 18, 'success': 8, 'collisions': 10}, {'tx': 5, 'success': 0, 'collisions': 5}, {'tx': 25, 'success': 11, 'collisions': 14}, {'tx': 6, 'success': 1, 'collisions': 5}, {'tx': 9, 'success': 2, 'collisions': 7}, {'tx': 18, 'success': 7, 'collisions': 11}, {'tx': 15, 'success': 5, 'collisions': 10}, {'tx': 13, 'success': 3, 'collisions': 10}, {'tx': 5, 'success': 0, 'collisions': 5}, {'tx': 5, 'success': 0, 'collisions': 5}, {'tx': 19, 'success': 8, 'collisions': 11}, {'tx': 16, 'success': 6, 'collisions': 10}, {'tx': 12, 'success': 3, 'collisions': 9}, {'tx': 13, 'success': 4, 'collisions': 9}, {'tx': 28, 'success': 14, 'collisions': 14}, {'tx': 26, 'success': 14, 'collisions': 12}, {'tx': 17, 'success': 8, 'collisions': 9}, {'tx': 8, 'success': 1, 'collisions': 7}, {'tx': 15, 'success': 5, 'collisions': 10}, {'tx': 14, 'success': 6, 'collisions': 8}, {'tx': 6, 'success': 0, 'collisions': 6}, {'tx': 17, 'success': 4, 'collisions': 13}, {'tx': 11, 'success': 2, 'collisions': 9}]"
139,30,40,397,135,262,0.6599496221662469,0.34005037783375314,0.54,"[{'tx': 11, 'success': 4, 'collisions': 7}, {'tx': 7, 'success': 1, 'collisions': 6}, {'tx': 13, 'success': 4, 'collisions': 9}, {'tx': 5, 'success': 0, 'collisions': 5}, {'tx': 14, 'success': 5, 'collisions': 9}, {'tx': 9, 'success': 2, 'collisions': 7}, {'tx': 21, 'success': 9, 'collisions': 12}, {'tx': 11, 'success': 4, 'collisions': 7}, {'tx': 14, 'success': 3, 'collisions': 11}, {'tx': 6, 'success': 0, 'collisions': 6}, {'tx': 18, 'success': 9, 'collisions': 9}, {'tx': 5, 'success': 0, 'collisions': 5}, {'tx': 17, 'success': 6, 'collisions': 11}, {'tx': 9, 'success': 1, 'collisions': 8}, {'tx': 5, 'success': 0, 'collisions': 5}, {'tx': 5, 'success': 0, 'collisions': 5}, {'tx': 20, 'success': 9, 'collisions': 11}, {'tx': 24, 'success': 10, 'collisions': 14}, {'tx': 19, 'success': 7, 'collisions': 12}, {'tx': 28, 'success': 14, 'collisions': 14}, {'tx': 10, 'success': 3, 'collisions': 7}, {'tx': 18, 'success': 7, 'collisions': 11}, {'tx': 12, 'success': 2, 'collisions': 10}, {'tx': 5, 'success': 0, 'collisions': 5}, {'tx': 5, 'success': 0, 'collisions': 5}, {'tx': 6, 'success': 0, 'collisions': 6}, {'tx': 14, 'success': 5, 'collisions': 9}, {'tx': 23, 'success': 11, 'collisions': 12}, {'tx': 15, 'success': 6, 'collisions': 9}, {'tx': 28, 'success': 13, 'collisions': 15}]"
140,30,41,395,138,257,0.6506329113924051,0.3493670886075949,0.5658,"[{'tx': 18, 'success': 7, 'collisions': 11}, {'tx': 18, 'success': 8, 'collisions': 10}, {'tx': 11, 'success': 3, 'collisions': 8}, {'tx': 14, 'success': 4, 'collisions': 10}, {'tx': 13, 'success': 5, 'collisions': 8}, {'tx': 25, 'success': 14, 'collisions': 11}, {'tx': 5, 'success': 0, 'collisions': 5}, {'tx': 21, 'success': 8, 'collisions': 13}, {'tx': 4, 'success': 0, 'collisions': 4}, {'tx': 10, 'success': 2, 'collisions': 8}, {'tx': 10, 'success': 3, 'collisions': 7}, {'tx': 22, 'success': 9, 'collisions': 13}, {'tx': 5, 'success': 0, 'collisions': 5}, {'tx': 14, 'success': 4, 'collisions': 10}, {'tx': 19, 'success': 6, 'collisions': 13}, {'tx': 5, 'success': 0, 'collisions': 5}, {'tx': 13, 'success': 3, 'collisions': 10}, {'tx': 16, 'success': 5, 'collisions': 11}, {'tx': 13, 'success': 4, 'collisions': 9}, {'tx': 9, 'success': 2, 'collisions': 7}, {'tx': 5, 'success': 1, 'collisions': 4}, {'tx': 27, 'success': 15, 'collisions': 12}, {'tx': 6, 'success': 1, 'collisions': 5}, {'tx': 7, 'success': 1, 'collisions': 6}, {'tx': 19, 'success': 8, 'collisions': 11}, {'tx': 13, 'success': 5, 'collisions': 8}, {'tx': 5, 'success': 0, 'collisions': 5}, {'tx': 21, 'success': 10, 'collisions': 11}, {'tx': 13, 'success': 5, 'collisions': 8}, {'tx': 14, 'success': 5, 'collisions': 9}]"
141,30,42,393,130,263,0.6692111959287532,0.33078880407124683,0.546,"[{'tx': 24, 'success': 12, 'collisions': 12}, {'tx': 5, 'success': 0, 'collisions': 5}, {'tx': 9, 'success': 2, 'collisions': 7}, {'tx': 6, 'success': 1, 'collisions': 5}, {'tx': 8, 'success': 1, 'collisions': 7}, {'tx': 15, 'success': 6, 'collisions': 9}, {'tx': 7, 'success': 1, 'collisions': 6}, {'tx': 17, 'success': 6, 'collisions': 11}, {'tx': 10, 'success': 1, 'collisions': 9}, {'tx': 13, 'success': 4, 'collisions': 9}, {'tx': 7, 'success': 1, 'collisions': 6}, {'tx': 11, 'success': 2, 'collisions': 9}, {'tx': 28, 'success': 12, 'collisions': 16}, {'tx': 7, 'success': 1, 'collisions': 6}, {'tx': 14, 'success': 6, 'collisions': 8}, {'tx': 15, 'success': 3, 'collisions': 12}, {'tx': 12, 'success': 3, 'collisions': 9}, {'tx': 21, 'success': 9, 'collisions': 12}, {'tx': 8, 'success': 1, 'collisions': 7}, {'tx': 5, 'success': 0, 'collisions': 5}, {'tx': 25, 'success': 13, 'collisions': 12}, {'tx': 19, 'success': 8, 'collisions': 11}, {'tx': 27, 'success': 13, 'collisions': 14}, {'tx': 20, 'success': 8, 'collisions': 12}, {'tx': 20, 'success': 10, 'collisions': 10}, {'tx': 8, 'success': 1, 'collisions': 7}, {'tx': 9, 'success': 3, 'collisions': 6}, {'tx': 9, 'success': 1, 'collisions': 8}, {'tx': 5, 'success': 0, 'collisions': 5}, {'tx': 9, 'success': 1, 'collisions': 8}]"
142,30,43,387,132,255,0.6589147286821705,0.34108527131782945,0.5676,"[{'tx': 14, 'success': 3, 'collisions': 11}, {'tx': 14, 'success': 5, 'collisions': 9}, {'tx': 13, 'success': 3, 'collisions': 10}, {'tx': 4, 'success': 0, 'collisions': 4}, {'tx': 15, 'success': 5, 'collisions': 10}, {'tx': 22, 'success': 11, 'collisions': 11}, {'tx': 20, 'success': 9, 'collisions': 11}, {'tx': 14, 'success': 4, 'collisions': 10}, {'tx': 9, 'success': 3, 'collisions': 6}, {'tx': 16, 'success': 6, 'collisions': 10}, {'tx': 21, 'success': 9, 'collisions': 12}, {'tx': 8, 'success': 2, 'collisions': 6}, {'tx': 5, 'success': 0, 'collisions': 5}, {'tx': 17, 'success': 5, 'collisions': 12}, {'tx': 5, 'success': 0, 'collisions': 5}, {'tx': 11, 'success': 3, 'collisions': 8}, {'tx': 10, 'success': 3, 'collisions': 7}, {'tx': 8, 'success': 2, 'collisions': 6}, {'tx': 10, 'success': 2, 'collisions': 8}, {'tx': 10, 'success': 3, 'collisions': 7}, {'tx': 23, 'success': 13, 'collisions': 10}, {'tx': 25, 'success': 11, 'collisions': 14}, {'tx': 7, 'success': 1, 'collisions': 6}, {'tx': 17, 'success': 7, 'collisions': 10}, {'tx': 6, 'success': 0, 'collisions': 6}, {'tx': 21, 'success': 10, 'collisions': 11}, {'tx': 14, 'success': 5, 'collisions': 9}, {'tx': 5, 'success': 0, 'collisions': 5}, {'tx': 19, 'success': 7, 'collisions': 12}, {'tx': 4, 'success': 0, 'collisions': 4}]"
143,30,44,380,124,256,0.6736842105263158,0.3263157894736842,0.5456,"[{'tx': 9, 'success': 1, 'collisions': 8}, {'tx': 9, 'success': 3, 'collisions': 6}, {'tx': 16, 'success': 6, 'collisions': 10}, {'tx': 8, 'success': 1, 'collisions': 7}, {'tx': 16, 'success': 5, 'collisions': 11}, {'tx': 13, 'success': 6, 'collisions': 7}, {'tx': 14, 'success': 4, 'collisions': 10}, {'tx': 5, 'success': 0, 'collisions': 5}, {'tx': 20, 'success': 8, 'collisions': 12}, {'tx': 6, 'success': 1, 'collisions': 5}, {'tx': 13, 'success': 4, 'collisions': 9}, {'tx': 26, 'success': 15, 'collisions': 11}, {'tx': 14, 'success': 5, 'collisions': 9}, {'tx': 12, 'success': 2, 'collisions': 10}, {'tx': 9, 'success': 2, 'collisions': 7}, {'tx': 5, 'success': 0, 'collisions': 5}, {'tx': 9, 'success': 2, 'collisions': 7}, {'tx': 12, 'success': 4, 'collisions': 8}, {'tx': 5, 'success': 0, 'collisions': 5}, {'tx': 27, 'success': 12, 'collisions': 15}, {'tx': 17, 'success': 4, 'collisions': 13}, {'tx': 20, 'success': 8, 'collisions': 12}, {'tx': 16, 'success': 5, 'collisions': 11}, {'tx': 11, 'success': 3, 'collisions': 8}, {'tx': 19, 'success': 9, 'collisions': 10}, {'tx': 9, 'success': 2, 'collisions': 7}, {'tx': 5, 'success': 0, 'collisions': 5}, {'tx': 17, 'success': 8, 'collisions': 9}, {'tx': 8, 'success': 1, 'collisions': 7}, {'tx': 10, 'success': 3, 'collisions': 7}]"
144,30,45,351,125,226,0.6438746438746439,0.3561253561253561,0.5625,"[{'tx': 19, 'success': 10, 'collisions': 9}, {'tx': 5, 'success': 1, 'collisions': 4}, {'tx': 6, 'success': 1, 'collisions': 5}, {'tx': 14, 'success': 6, 'collisions': 8}, {'tx': 20, 'success': 7, 'collisions': 13}, {'tx': 10, 'success': 1, 'collisions': 9}, {'tx': 18, 'success': 11, 'collisions': 7}, {'tx': 26, 'success': 15, 'collisions': 11}, {'tx': 11, 'success': 3, 'collisions': 8}, {'tx': 7, 'success': 1, 'collisions': 6}, {'tx': 6, 'success': 1, 'collisions': 5}, {'tx': 17, 'success': 7, 'collisions': 10}, {'tx': 11, 'success': 4, 'collisions': 7}, {'tx': 5, 'success': 0, 'collisions': 5}, {'tx': 21, 'success': 10, 'collisions': 11}, {'tx': 5, 'success': 0, 'collisions': 5}, {'tx': 14, 'success': 4, 'collisions': 10}, {'tx': 23, 'success': 12, 'collisions': 11}, {'tx': 8, 'success': 2, 'collisions': 6}, {'tx': 12, 'success': 4, 'collisions': 8}, {'tx': 6, 'success': 1, 'collisions': 5}, {'tx': 5, 'success': 0, 'collisions': 5}, {'tx': 20, 'success': 9, 'collisions': 11}, {'tx': 10, 'success': 4, 'collisions': 6}, {'tx': 10, 'success': 3, 'collisions': 7}, {'tx': 4, 'success': 0, 'collisions': 4}, {'tx': 9, 'success': 1, 'collisions': 8}, {'tx': 4, 'success': 0, 'collisions': 4}, {'tx': 8, 'success': 1, 'collisions': 7}, {'tx': 17, 'success': 6, 'collisions': 11}]"
145,30,46,343,120,223,0.6501457725947521,0.3498542274052478,0.552,"[{'tx': 9, 'success': 3, 'collisions': 6}, {'tx': 6, 'success': 0, 'collisions': 6}, {'tx': 10, 'success': 2, 'collisions': 8}, {'tx': 12, 'success': 5, 'collisions': 7}, {'tx': 18, 'success': 7, 'collisions': 11}, {'tx': 17, 'success': 9, 'collisions': 8}, {'tx': 4, 'success': 0, 'collisions': 4}, {'tx': 11, 'success': 3, 'collisions': 8}, {'tx': 8, 'success': 1, 'collisions': 7}, {'tx': 6, 'success': 1, 'collisions': 5}, {'tx': 22, 'success': 12, 'collisions': 10}, {'tx': 13, 'success': 4, 'collisions': 9}, {'tx': 11, 'success': 4, 'collisions': 7}, {'tx': 7, 'success': 1, 'collisions': 6}, {'tx': 5, 'success': 0, 'collisions': 5}, {'tx': 23, 'success': 13, 'collisions': 10}, {'tx': 5, 'success': 0, 'collisions': 5}, {'tx': 7, 'success': 2, 'collisions': 5}, {'tx': 10, 'success': 3, 'collisions': 7}, {'tx': 10, 'success': 3, 'collisions': 7}, {'tx': 17, 'success': 8, 'collisions': 9}, {'tx': 7, 'success': 1, 'collisions': 6}, {'tx': 5, 'success': 0, 'collisions': 5}, {'tx': 14, 'success': 5, 'collisions': 9}, {'tx': 18, 'success': 7, 'collisions': 11}, {'tx': 14, 'success': 5, 'collisions': 9}, {'tx': 4, 'success': 0, 'collisions': 4}, {'tx': 11, 'success': 4, 'collisions': 7}, {'tx': 16, 'success': 7, 'collisions': 9}, {'tx': 23, 'success': 10, 'collisions': 13}]"
146,30,47,346,121,225,0.6502890173410405,0.34971098265895956,0.5687,"[{'tx': 17, 'success': 7, 'collisions': 10}, {'tx': 4, 'success': 0, 'collisions': 4}, {'tx': 12, 'success': 5, 'collisions': 7}, {'tx': 5, 'success': 0, 'collisions': 5}, {'tx': 8, 'success': 1, 'collisions': 7}, {'tx': 12, 'success': 4, 'collisions': 8}, {'tx': 5, 'success': 0, 'collisions': 5}, {'tx': 5, 'success': 1, 'collisions': 4}, {'tx': 17, 'success': 8, 'collisions': 9}, {'tx': 9, 'success': 2, 'collisions': 7}, {'tx': 9, 'success': 2, 'collisions': 7}, {'tx': 5, 'success': 0, 'collisions': 5}, {'tx': 18, 'success': 9, 'collisions': 9}, {'tx': 18, 'success': 8, 'collisions': 10}, {'tx': 12, 'success': 5, 'collisions': 7}, {'tx': 15, 'success': 7, 'collisions': 8}, {'tx': 17, 'success': 6, 'collisions': 11}, {'tx': 8, 'success': 2, 'collisions': 6}, {'tx': 14, 'success': 5, 'collisions': 9}, {'tx': 8, 'success': 1, 'collisions': 7}, {'tx': 17, 'success': 7, 'collisions': 10}, {'tx': 6, 'success': 1, 'collisions': 5}, {'tx': 16, 'success': 9, 'collisions': 7}, {'tx': 13, 'success': 4, 'collisions': 9}, {'tx': 15, 'success': 7, 'collisions': 8}, {'tx': 11, 'success': 3, 'collisions': 8}, {'tx': 10, 'success': 4, 'collisions': 6}, {'tx': 16, 'success': 7, 'collisions': 9}, {'tx': 13, 'success': 3, 'collisions': 10}, {'tx': 11, 'success': 3, 'collisions': 8}]"
147,30,48,346,113,233,0.6734104046242775,0.3265895953757225,0.5424,"[{'tx': 13, 'success': 5, 'collisions': 8}, {'tx': 9, 'success': 1, 'collisions': 8}, {'tx': 19, 'success': 8, 'collisions': 11}, {'tx': 22, 'success': 9, 'collisions': 13}, {'tx': 15, 'success': 6, 'collisions': 9}, {'tx': 21, 'success': 11, 'collisions': 10}, {'tx': 10, 'success': 2, 'collisions': 8}, {'tx': 6, 'success': 0, 'collisions': 6}, {'tx': 14, 'success': 3, 'collisions': 11}, {'tx': 5, 'success': 0, 'collisions': 5}, {'tx': 5, 'success': 0, 'collisions': 5}, {'tx': 5, 'success': 0, 'collisions': 5}, {'tx': 9, 'success': 4, 'collisions': 5}, {'tx': 18, 'success': 7, 'collisions': 11}, {'tx': 5, 'success': 0, 'collisions': 5}, {'tx': 12, 'success': 5, 'collisions': 7}, {'tx': 13, 'success': 4, 'collisions': 9}, {'tx': 5, 'success': 0, 'collisions': 5}, {'tx': 13, 'success': 5, 'collisions': 8}, {'tx': 4, 'success': 0, 'collisions': 4}, {'tx': 15, 'success': 4, 'collisions': 11}, {'tx': 13, 'success': 5, 'collisions': 8}, {'tx': 8, 'success': 1, 'collisions': 7}, {'tx': 7, 'success': 1, 'collisions': 6}, {'tx': 14, 'success': 4, 'collisions': 10}, {'tx': 5, 'success': 0, 'collisions': 5}, {'tx': 11, 'success': 3, 'collisions': 8}, {'tx': 7, 'success': 1, 'collisions': 6}, {'tx': 13, 'success': 6, 'collisions': 7}, {'tx': 30, 'success': 18, 'collisions': 12}]"
148,30,49,321,124,197,0.6137071651090342,0.3862928348909657,0.6076,"[{'tx': 10, 'success': 3, 'collisions': 7}, {'tx': 23, 'success': 15, 'collisions': 8}, {'tx': 4, 'success': 0, 'collisions': 4}, {'tx': 13, 'success': 4, 'collisions': 9}, {'tx': 6, 'success': 1, 'collisions': 5}, {'tx': 18, 'success': 10, 'collisions': 8}, {'tx': 7, 'success': 1, 'collisions': 6}, {'tx': 8, 'success': 1, 'collisions': 7}, {'tx': 10, 'success': 3, 'collisions': 7}, {'tx': 6, 'success': 1, 'collisions': 5}, {'tx': 4, 'success': 0, 'collisions': 4}, {'tx': 20, 'success': 13, 'collisions': 7}, {'tx': 11, 'success': 3, 'collisions': 8}, {'tx': 5, 'success': 0, 'collisions': 5}, {'tx': 4, 'success': 0, 'collisions': 4}, {'tx': 5, 'success': 1, 'collisions': 4}, {'tx': 12, 'success': 5, 'collisions': 7}, {'tx': 19, 'success': 12, 'collisions': 7}, {'tx': 5, 'success': 0, 'collisions': 5}, {'tx': 11, 'success': 5, 'collisions': 6}, {'tx': 7, 'success': 1, 'collisions': 6}, {'tx': 8, 'success': 2, 'collisions': 6}, {'tx': 7, 'success': 3, 'collisions': 4}, {'tx': 17, 'success': 8, 'collisions': 9}, {'tx': 8, 'success': 1, 'collisions': 7}, {'tx': 12, 'success': 5, 'collisions': 7}, {'tx': 14, 'success': 7, 'collisions': 7}, {'tx': 19, 'success': 7, 'collisions': 12}, {'tx': 12, 'success': 5, 'collisions': 7}, {'tx': 16, 'success': 7, 'collisions': 9}]"
149,30,50,329,112,217,0.6595744680851063,0.3404255319148936,0.56,"[{'tx': 24, 'success': 12, 'collisions': 12}, {'tx': 13, 'success': 5, 'collisions': 8}, {'tx': 7, 'success': 1, 'collisions': 6}, {'tx': 4, 'success': 0, 'collisions': 4}, {'tx': 17, 'success': 8, 'collisions': 9}, {'tx': 11, 'success': 5, 'collisions': 6}, {'tx': 12, 'success': 5, 'collisions': 7}, {'tx': 6, 'success': 1, 'collisions': 5}, {'tx': 7, 'success': 1, 'collisions': 6}, {'tx': 11, 'success': 3, 'collisions': 8}, {'tx': 16, 'success': 8, 'collisions': 8}, {'tx': 12, 'success': 5, 'collisions': 7}, {'tx': 13, 'success': 7, 'collisions': 6}, {'tx': 15, 'success': 6, 'collisions': 9}, {'tx': 4, 'success': 0, 'collisions': 4}, {'tx': 9, 'success': 2, 'collisions': 7}, {'tx': 11, 'success': 2, 'collisions': 9}, {'tx': 15, 'success': 5, 'collisions': 10}, {'tx': 14, 'success': 5, 'collisions': 9}, {'tx': 13, 'success': 5, 'collisions': 8}, {'tx': 7, 'success': 1, 'collisions': 6}, {'tx': 10, 'success': 3, 'collisions': 7}, {'tx': 8, 'success': 2, 'collisions': 6}, {'tx': 7, 'success': 1, 'collisions': 6}, {'tx': 7, 'success': 1, 'collisions': 6}, {'tx': 12, 'success': 4, 'collisions': 8}, {'tx': 15, 'success': 7, 'collisions': 8}, {'tx': 11, 'success': 3, 'collisions': 8}, {'tx': 7, 'success': 1, 'collisions': 6}, {'tx': 11, 'success': 3, 'collisions': 8}]"
150,30,51,320,100,220,0.6875,0.3125,0.51,"[{'tx': 5, 'success': 0, 'collisions': 5}, {'tx': 5, 'success': 0, 'collisions': 5}, {'tx': 17, 'success': 10, 'collisions': 7}, {'tx': 12, 'success': 3, 'collisions': 9}, {'tx': 16, 'success': 6, 'collisions': 10}, {'tx': 15, 'success': 5, 'collisions': 10}, {'tx': 6, 'success': 0, 'collisions': 6}, {'tx': 23, 'success': 14, 'collisions': 9}, {'tx': 4, 'success': 0, 'collisions': 4}, {'tx': 10, 'success': 3, 'collisions': 7}, {'tx': 12, 'success': 4, 'collisions': 8}, {'tx': 13, 'success': 5, 'collisions': 8}, {'tx': 10, 'success': 3, 'collisions': 7}, {'tx': 12, 'success': 3, 'collisions': 9}, {'tx': 23, 'success': 13, 'collisions': 10}, {'tx': 5, 'success': 0, 'collisions': 5}, {'tx': 8, 'success': 1, 'collisions': 7}, {'tx': 5, 'success': 0, 'collisions': 5}, {'tx': 14, 'success': 5, 'collisions': 9}, {'tx': 5, 'success': 0, 'collisions': 5}, {'tx': 6, 'success': 0, 'collisions': 6}, {'tx': 4, 'success': 0, 'collisions': 4}, {'tx': 17, 'success': 7, 'collisions': 10}, {'tx': 5, 'success': 0, 'collisions': 5}, {'tx': 11, 'success': 2, 'collisions': 9}, {'tx': 12, 'success': 3, 'collisions': 9}, {'tx': 17, 'success': 7, 'collisions': 10}, {'tx': 4, 'success': 0, 'collisions': 4}, {'tx': 19, 'success': 6, 'collisions': 13}, {'tx': 5, 'success': 0, 'collisions': 5}]"
151,30,52,315,101,214,0.6793650793650794,0.32063492063492066,0.5252,"[{'tx': 13, 'success': 7, 'collisions': 6}, {'tx': 8, 'success': 2, 'collisions': 6}, {'tx': 7, 'success': 1, 'collisions': 6}, {'tx': 14, 'success': 4, 'collisions': 10}, {'tx': 9, 'success': 2, 'collisions': 7}, {'tx': 4, 'success': 0, 'collisions': 4}, {'tx': 15, 'success': 6, 'collisions': 9}, {'tx': 5, 'success': 1, 'collisions': 4}, {'tx': 14, 'success': 4, 'collisions': 10}, {'tx': 15, 'success': 5, 'collisions': 10}, {'tx': 5, 'success': 0, 'collisions': 5}, {'tx': 10, 'success': 3, 'collisions': 7}, {'tx': 11, 'success': 3, 'collisions': 8}, {'tx': 19, 'success': 7, 'collisions': 12}, {'tx': 12, 'success': 4, 'collisions': 8}, {'tx': 9, 'success': 4, 'collisions': 5}, {'tx': 14, 'success': 5, 'collisions': 9}, {'tx': 13, 'success': 4, 'collisions': 9}, {'tx': 10, 'success': 3, 'collisions': 7}, {'tx': 5, 'success': 1, 'collisions': 4}, {'tx': 8, 'success': 2, 'collisions': 6}, {'tx': 11, 'success': 3, 'collisions': 8}, {'tx': 11, 'success': 5, 'collisions': 6}, {'tx': 9, 'success': 2, 'collisions': 7}, {'tx': 11, 'success': 4, 'collisions': 7}, {'tx': 11, 'success': 5, 'collisions': 6}, {'tx': 15, 'success': 6, 'collisions': 9}, {'tx': 15, 'success': 7, 'collisions': 8}, {'tx': 7, 'success': 1, 'collisions': 6}, {'tx': 5, 'success': 0, 'collisions': 5}]"
152,30,53,307,108,199,0.6482084690553745,0.3517915309446254,0.5724,"[{'tx': 7, 'success': 1, 'collisions': 6}, {'tx': 18, 'success': 10, 'collisions': 8}, {'tx': 6, 'success': 1, 'collisions': 5}, {'tx': 11, 'success': 4, 'collisions': 7}, {'tx': 13, 'success': 7, 'collisions': 6}, {'tx': 4, 'success': 0, 'collisions': 4}, {'tx': 11, 'success': 5, 'collisions': 6}, {'tx': 4, 'success': 0, 'collisions': 4}, {'tx': 18, 'success': 10, 'collisions': 8}, {'tx': 9, 'success': 2, 'collisions': 7}, {'tx': 16, 'success': 7, 'collisions': 9}, {'tx': 18, 'success': 7, 'collisions': 11}, {'tx': 5, 'success': 0, 'collisions': 5}, {'tx': 14, 'success': 7, 'collisions': 7}, {'tx': 12, 'success': 5, 'collisions': 7}, {'tx': 12, 'success': 6, 'collisions': 6}, {'tx': 13, 'success': 5, 'collisions': 8}, {'tx': 4, 'success': 0, 'collisions': 4}, {'tx': 13, 'success': 4, 'collisions': 9}, {'tx': 10, 'success': 3, 'collisions': 7}, {'tx': 7, 'success': 1, 'collisions': 6}, {'tx': 8, 'success': 2, 'collisions': 6}, {'tx': 7, 'success': 1, 'collisions': 6}, {'tx': 9, 'success': 2, 'collisions': 7}, {'tx': 19, 'success': 9, 'collisions': 10}, {'tx': 7, 'success': 1, 'collisions': 6}, {'tx': 4, 'success': 0, 'collisions': 4}, {'tx': 5, 'success': 0, 'collisions': 5}, {'tx': 18, 'success': 8, 'collisions': 10}, {'tx': 5, 'success': 0, 'collisions': 5}]"
153,30,54,301,101,200,0.6644518272425249,0.33554817275747506,0.5454,"[{'tx': 5, 'success': 0, 'collisions': 5}, {'tx': 13, 'success': 4, 'collisions': 9}, {'tx': 4, 'success': 0, 'collisions': 4}, {'tx': 7, 'success': 3, 'collisions': 4}, {'tx': 5, 'success': 1, 'collisions': 4}, {'tx': 10, 'success': 3, 'collisions': 7}, {'tx': 16, 'success': 5, 'collisions': 11}, {'tx': 9, 'success': 2, 'collisions': 7}, {'tx': 7, 'success': 1, 'collisions': 6}, {'tx': 9, 'success': 3, 'collisions': 6}, {'tx': 4, 'success': 0, 'collisions': 4}, {'tx': 12, 'success': 4, 'collisions': 8}, {'tx': 8, 'success': 3, 'collisions': 5}, {'tx': 12, 'success': 4, 'collisions': 8}, {'tx': 18, 'success': 8, 'collisions': 10}, {'tx': 4, 'success': 0, 'collisions': 4}, {'tx': 8, 'success': 3, 'collisions': 5}, {'tx': 6, 'success': 1, 'collisions': 5}, {'tx': 7, 'success': 1, 'collisions': 6}, {'tx': 7, 'success': 1, 'collisions': 6}, {'tx': 13, 'success': 4, 'collisions': 9}, {'tx': 17, 'success': 7, 'collisions': 10}, {'tx': 4, 'success': 0, 'collisions': 4}, {'tx': 9, 'success': 4, 'collisions': 5}, {'tx': 13, 'success': 6, 'collisions': 7}, {'tx': 24, 'success': 13, 'collisions': 11}, {'tx': 14, 'success': 5, 'collisions': 9}, {'tx': 10, 'success': 2, 'collisions': 8}, {'tx': 17, 'success': 10, 'collisions': 7}, {'tx': 9, 'success': 3, 'collisions': 6}]"
154,30,55,291,100,191,0.6563573883161512,0.3436426116838488,0.55,"[{'tx': 10, 'success': 5, 'collisions': 5}, {'tx': 4, 'success': 0, 'collisions': 4}, {'tx': 7, 'success': 1, 'collisions': 6}, {'tx': 5, 'success': 1, 'collisions': 4}, {'tx': 8, 'success': 2, 'collisions': 6}, {'tx': 4, 'success': 0, 'collisions': 4}, {'tx': 12, 'success': 6, 'collisions': 6}, {'tx': 4, 'success': 0, 'collisions': 4}, {'tx': 4, 'success': 0, 'collisions': 4}, {'tx': 4, 'success': 0, 'collisions': 4}, {'tx': 9, 'success': 1, 'collisions': 8}, {'tx': 13, 'success': 5, 'collisions': 8}, {'tx': 5, 'success': 1, 'collisions': 4}, {'tx': 10, 'success': 2, 'collisions': 8}, {'tx': 13, 'success': 4, 'collisions': 9}, {'tx': 22, 'success': 14, 'collisions': 8}, {'tx': 18, 'success': 8, 'collisions': 10}, {'tx': 11, 'success': 3, 'collisions': 8}, {'tx': 9, 'success': 2, 'collisions': 7}, {'tx': 15, 'success': 7, 'collisions': 8}, {'tx': 9, 'success': 3, 'collisions': 6}, {'tx': 9, 'success': 2, 'collisions': 7}, {'tx': 9, 'success': 4, 'collisions': 5}, {'tx': 8, 'success': 1, 'collisions': 7}, {'tx': 4, 'success': 0, 'collisions': 4}, {'tx': 7, 'success': 2, 'collisions': 5}, {'tx': 26, 'success': 13, 'collisions': 13}, {'tx': 9, 'success': 2, 'collisions': 7}, {'tx': 5, 'success': 0, 'collisions': 5}, {'tx': 18, 'success': 11, 'collisions': 7}]"
155,30,56,294,100,194,0.6598639455782312,0.3401360544217687,0.56,"[{'tx': 11, 'success': 3, 'collisions': 8}, {'tx': 5, 'success': 1, 'collisions': 4}, {'tx': 13, 'success': 4, 'collisions': 9}, {'tx': 6, 'success': 2, 'collisions': 4}, {'tx': 16, 'success': 6, 'collisions': 10}, {'tx': 4, 'success': 0, 'collisions': 4}, {'tx': 6, 'success': 1, 'collisions': 5}, {'tx': 14, 'success': 6, 'collisions': 8}, {'tx': 12, 'success': 5, 'collisions': 7}, {'tx': 4, 'success': 0, 'collisions': 4}, {'tx': 8, 'success': 2, 'collisions': 6}, {'tx': 4, 'success': 0, 'collisions': 4}, {'tx': 7, 'success': 1, 'collisions': 6}, {'tx': 14, 'success': 8, 'collisions': 6}, {'tx': 19, 'success': 11, 'collisions': 8}, {'tx': 9, 'success': 2, 'collisions': 7}, {'tx': 10, 'success': 4, 'collisions': 6}, {'tx': 4, 'success': 0, 'collisions': 4}, {'tx': 13, 'success': 5, 'collisions': 8}, {'tx': 15, 'success': 7, 'collisions': 8}, {'tx': 15, 'success': 7, 'collisions': 8}, {'tx': 16, 'success': 6, 'collisions': 10}, {'tx': 6, 'success': 0, 'collisions': 6}, {'tx': 17, 'success': 6, 'collisions': 11}, {'tx': 4, 'success': 0, 'collisions': 4}, {'tx': 4, 'success': 0, 'collisions': 4}, {'tx': 18, 'success': 9, 'collisions': 9}, {'tx': 6, 'success': 1, 'collisions': 5}, {'tx': 7, 'success': 1, 'collisions': 6}, {'tx': 7, 'success': 2, 'collisions': 5}]"
156,30,57,286,97,189,0.6608391608391608,0.33916083916083917,0.5529,"[{'tx': 4, 'success': 0, 'collisions': 4}, {'tx': 5, 'success': 1, 'collisions': 4}, {'tx': 12, 'success': 5, 'collisions': 7}, {'tx': 15, 'success': 7, 'collisions': 8}, {'tx': 9, 'success': 3, 'collisions': 6}, {'tx': 4, 'success': 0, 'collisions': 4}, {'tx': 14, 'success': 7, 'collisions': 7}, {'tx': 4, 'success': 0, 'collisions': 4}, {'tx': 15, 'success': 6, 'collisions': 9}, {'tx': 7, 'success': 2, 'collisions': 5}, {'tx': 14, 'success': 6, 'collisions': 8}, {'tx': 7, 'success': 1, 'collisions': 6}, {'tx': 9, 'success': 3, 'collisions': 6}, {'tx': 5, 'success': 0, 'collisions': 5}, {'tx': 12, 'success': 4, 'collisions': 8}, {'tx': 5, 'success': 0, 'collisions': 5}, {'tx': 9, 'success': 3, 'collisions': 6}, {'tx': 16, 'success': 8, 'collisions': 8}, {'tx': 12, 'success': 5, 'collisions': 7}, {'tx': 11, 'success': 3, 'collisions': 8}, {'tx': 11, 'success': 3, 'collisions': 8}, {'tx': 4, 'success': 0, 'collisions': 4}, {'tx': 15, 'success': 7, 'collisions': 8}, {'tx': 20, 'success': 11, 'collisions': 9}, {'tx': 10, 'success': 4, 'collisions': 6}, {'tx': 6, 'success': 1, 'collisions': 5}, {'tx': 12, 'success': 3, 'collisions': 9}, {'tx': 11, 'success': 4, 'collisions': 7}, {'tx': 4, 'success': 0, 'collisions': 4}, {'tx': 4, 'success': 0, 'collisions': 4}]"
157,30,58,291,89,202,0.6941580756013745,0.30584192439862545,0.5162,"[{'tx': 7, 'success': 1, 'collisions': 6}, {'tx': 4, 'success': 0, 'collisions': 4}, {'tx': 6, 'success': 1, 'collisions': 5}, {'tx': 11, 'success': 4, 'collisions': 7}, {'tx': 8, 'success': 1, 'collisions': 7}, {'tx': 10, 'success': 3, 'collisions': 7}, {'tx': 11, 'success': 5, 'collisions': 6}, {'tx': 13, 'success': 7, 'collisions': 6}, {'tx': 13, 'success': 5, 'collisions': 8}, {'tx': 12, 'success': 5, 'collisions': 7}, {'tx': 6, 'success': 0, 'collisions': 6}, {'tx': 8, 'success': 1, 'collisions': 7}, {'tx': 11, 'success': 4, 'collisions': 7}, {'tx': 9, 'success': 2, 'collisions': 7}, {'tx': 10, 'success': 2, 'collisions': 8}, {'tx': 9, 'success': 3, 'collisions': 6}, {'tx': 9, 'success': 2, 'collisions': 7}, {'tx': 4, 'success': 0, 'collisions': 4}, {'tx': 15, 'success': 7, 'collisions': 8}, {'tx': 11, 'success': 3, 'collisions': 8}, {'tx': 8, 'success': 2, 'collisions': 6}, {'tx': 15, 'success': 6, 'collisions': 9}, {'tx': 8, 'success': 1, 'collisions': 7}, {'tx': 7, 'success': 1, 'collisions': 6}, {'tx': 12, 'success': 3, 'collisions': 9}, {'tx': 11, 'success': 3, 'collisions': 8}, {'tx': 12, 'success': 4, 'collisions': 8}, {'tx': 17, 'success': 10, 'collisions': 7}, {'tx': 4, 'success': 0, 'collisions': 4}, {'tx': 10, 'success': 3, 'collisions': 7}]"
158,30,59,289,96,193,0.6678200692041523,0.33217993079584773,0.5664,"[{'tx': 4, 'success': 0, 'collisions': 4}, {'tx': 10, 'success': 4, 'collisions': 6}, {'tx': 13, 'success': 4, 'collisions': 9}, {'tx': 4, 'success': 0, 'collisions': 4}, {'tx': 4, 'success': 0, 'collisions': 4}, {'tx': 21, 'success': 10, 'collisions': 11}, {'tx': 4, 'success': 0, 'collisions': 4}, {'tx': 5, 'success': 0, 'collisions': 5}, {'tx': 19, 'success': 10, 'collisions': 9}, {'tx': 14, 'success': 7, 'collisions': 7}, {'tx': 10, 'success': 3, 'collisions': 7}, {'tx': 5, 'success': 0, 'collisions': 5}, {'tx': 16, 'success': 10, 'collisions': 6}, {'tx': 15, 'success': 6, 'collisions': 9}, {'tx': 13, 'success': 5, 'collisions': 8}, {'tx': 11, 'success': 3, 'collisions': 8}, {'tx': 10, 'success': 3, 'collisions': 7}, {'tx': 7, 'success': 2, 'collisions': 5}, {'tx': 11, 'success': 3, 'collisions': 8}, {'tx': 4, 'success': 0, 'collisions': 4}, {'tx': 13, 'success': 4, 'collisions': 9}, {'tx': 5, 'success': 0, 'collisions': 5}, {'tx': 5, 'success': 0, 'collisions': 5}, {'tx': 5, 'success': 0, 'collisions': 5}, {'tx': 10, 'success': 4, 'collisions': 6}, {'tx': 9, 'success': 3, 'collisions': 6}, {'tx': 5, 'success': 0, 'collisions': 5}, {'tx': 20, 'success': 12, 'collisions': 8}, {'tx': 5, 'success': 0, 'collisions': 5}, {'tx': 12, 'success': 3, 'collisions': 9}]"
159,30,60,285,91,194,0.6807017543859649,0.3192982456140351,0.546,"[{'tx': 13, 'success': 5, 'collisions': 8}, {'tx': 15, 'success': 6, 'collisions': 9}, {'tx': 17, 'success': 8, 'collisions': 9}, {'tx': 5, 'success': 0, 'collisions': 5}, {'tx': 7, 'success': 1, 'collisions': 6}, {'tx': 8, 'success': 2, 'collisions': 6}, {'tx': 11, 'success': 4, 'collisions': 7}, {'tx': 14, 'success': 6, 'collisions': 8}, {'tx': 17, 'success': 8, 'collisions': 9}, {'tx': 4, 'success': 0, 'collisions': 4}, {'tx': 4, 'success': 0, 'collisions': 4}, {'tx': 6, 'success': 1, 'collisions': 5}, {'tx': 12, 'success': 4, 'collisions': 8}, {'tx': 4, 'success': 0, 'collisions': 4}, {'tx': 10, 'success': 4, 'collisions': 6}, {'tx': 7, 'success': 1, 'collisions': 6}, {'tx': 10, 'success': 2, 'collisions': 8}, {'tx': 8, 'success': 3, 'collisions': 5}, {'tx': 5, 'success': 0, 'collisions': 5}, {'tx': 9, 'success': 2, 'collisions': 7}, {'tx': 8, 'success': 1, 'collisions': 7}, {'tx': 9, 'success': 3, 'collisions': 6}, {'tx': 4, 'success': 0, 'collisions': 4}, {'tx': 8, 'success': 2, 'collisions': 6}, {'tx': 14, 'success': 5, 'collisions': 9}, {'tx': 14, 'success': 7, 'collisions': 7}, {'tx': 12, 'success': 5, 'collisions': 7}, {'tx': 5, 'success': 0, 'collisions': 5}, {'tx': 7, 'success': 1, 'collisions': 6}, {'tx': 18, 'success': 10, 'collisions': 8}]"
160,30,61,277,85,192,0.6931407942238267,0.30685920577617326,0.5185,"[{'tx': 15, 'success': 7, 'collisions': 8}, {'tx': 10, 'success': 4, 'collisions': 6}, {'tx': 12, 'success': 4, 'collisions': 8}, {'tx': 9, 'success': 2, 'collisions': 7}, {'tx': 12, 'success': 3, 'collisions': 9}, {'tx': 9, 'success': 2, 'collisions': 7}, {'tx': 6, 'success': 1, 'collisions': 5}, {'tx': 16, 'success': 9, 'collisions': 7}, {'tx': 14, 'success': 5, 'collisions': 9}, {'tx': 17, 'success': 9, 'collisions': 8}, {'tx': 5, 'success': 0, 'collisions': 5}, {'tx': 7, 'success': 1, 'collisions': 6}, {'tx': 15, 'success': 6, 'collisions': 9}, {'tx': 10, 'success': 4, 'collisions': 6}, {'tx': 11, 'success': 5, 'collisions': 6}, {'tx': 11, 'success': 3, 'collisions': 8}, {'tx': 4, 'success': 0, 'collisions': 4}, {'tx': 7, 'success': 1, 'collisions': 6}, {'tx': 5, 'success': 0, 'collisions': 5}, {'tx': 4, 'success': 0, 'collisions': 4}, {'tx': 14, 'success': 6, 'collisions': 8}, {'tx': 10, 'success': 3, 'collisions': 7}, {'tx': 8, 'success': 2, 'collisions': 6}, {'tx': 4, 'success': 0, 'collisions': 4}, {'tx': 11, 'success': 4, 'collisions': 7}, {'tx': 7, 'success': 2, 'collisions': 5}, {'tx': 5, 'success': 0, 'collisions': 5}, {'tx': 9, 'success': 1, 'collisions': 8}, {'tx': 4, 'success': 0, 'collisions': 4}, {'tx': 6, 'success': 1, 'collisions': 5}]"
161,30,62,273,86,187,0.684981684981685,0.315018315018315,0.5332,"[{'tx': 9, 'success': 3, 'collisions': 6}, {'tx': 11, 'success': 4, 'collisions': 7}, {'tx': 15, 'success': 6, 'collisions': 9}, {'tx': 7, 'success': 1, 'collisions': 6}, {'tx': 5, 'success': 1, 'collisions': 4}, {'tx': 11, 'success': 5, 'collisions': 6}, {'tx': 12, 'success': 5, 'collisions': 7}, {'tx': 15, 'success': 7, 'collisions': 8}, {'tx': 8, 'success': 2, 'collisions': 6}, {'tx': 11, 'success': 4, 'collisions': 7}, {'tx': 13, 'success': 3, 'collisions': 10}, {'tx': 8, 'success': 3, 'collisions': 5}, {'tx': 5, 'success': 0, 'collisions': 5}, {'tx': 12, 'success': 5, 'collisions': 7}, {'tx': 10, 'success': 2, 'collisions': 8}, {'tx': 8, 'success': 3, 'collisions': 5}, {'tx': 13, 'success': 4, 'collisions': 9}, {'tx': 11, 'success': 4, 'collisions': 7}, {'tx': 11, 'success': 5, 'collisions': 6}, {'tx': 5, 'success': 0, 'collisions': 5}, {'tx': 8, 'success': 4, 'collisions': 4}, {'tx': 15, 'success': 7, 'collisions': 8}, {'tx': 5, 'success': 0, 'collisions': 5}, {'tx': 4, 'success': 0, 'collisions': 4}, {'tx': 5, 'success': 0, 'collisions': 5}, {'tx': 4, 'success': 0, 'collisions': 4}, {'tx': 4, 'success': 0, 'collisions': 4}, {'tx': 8, 'success': 1, 'collisions': 7}, {'tx': 13, 'success': 6, 'collisions': 7}, {'tx': 7, 'success': 1, 'collisions': 6}]"
162,30,63,265,92,173,0.6528301886792452,0.3471698113207547,0.5796,"[{'tx': 9, 'success': 4, 'collisions': 5}, {'tx': 15, 'success': 6, 'collisions': 9}, {'tx': 6, 'success': 1, 'collisions': 5}, {'tx': 4, 'success': 0, 'collisions': 4}, {'tx': 6, 'success': 0, 'collisions': 6}, {'tx': 16, 'success': 8, 'collisions': 8}, {'tx': 5, 'success': 0, 'collisions': 5}, {'tx': 7, 'success': 1, 'collisions': 6}, {'tx': 5, 'success': 0, 'collisions': 5}, {'tx': 16, 'success': 10, 'collisions': 6}, {'tx': 6, 'success': 1, 'collisions': 5}, {'tx': 12, 'success': 5, 'collisions': 7}, {'tx': 14, 'success': 6, 'collisions': 8}, {'tx': 9, 'success': 3, 'collisions': 6}, {'tx': 4, 'success': 0, 'collisions': 4}, {'tx': 4, 'success': 0, 'collisions': 4}, {'tx': 16, 'success': 9, 'collisions': 7}, {'tx': 9, 'success': 4, 'collisions': 5}, {'tx': 11, 'success': 4, 'collisions': 7}, {'tx': 10, 'success': 4, 'collisions': 6}, {'tx': 7, 'success': 2, 'collisions': 5}, {'tx': 5, 'success': 0, 'collisions': 5}, {'tx': 7, 'success': 1, 'collisions': 6}, {'tx': 4, 'success': 0, 'collisions': 4}, {'tx': 5, 'success': 1, 'collisions': 4}, {'tx': 4, 'success': 0, 'collisions': 4}, {'tx': 9, 'success': 3, 'collisions': 6}, {'tx': 14, 'success': 7, 'collisions': 7}, {'tx': 18, 'success': 10, 'collisions': 8}, {'tx': 8, 'success': 2, 'collisions': 6}]"
163,30,64,264,85,179,0.678030303030303,0.32196969696969696,0.544,"[{'tx': 10, 'success': 3, 'collisions': 7}, {'tx': 4, 'success': 0, 'collisions': 4}, {'tx': 4, 'success': 0, 'collisions': 4}, {'tx': 9, 'success': 3, 'collisions': 6}, {'tx': 10, 'success': 3, 'collisions': 7}, {'tx': 7, 'success': 2, 'collisions': 5}, {'tx': 13, 'success': 6, 'collisions': 7}, {'tx': 17, 'success': 9, 'collisions': 8}, {'tx': 7, 'success': 2, 'collisions': 5}, {'tx': 11, 'success': 4, 'collisions': 7}, {'tx': 10, 'success': 3, 'collisions': 7}, {'tx': 6, 'success': 1, 'collisions': 5}, {'tx': 14, 'success': 6, 'collisions': 8}, {'tx': 12, 'success': 4, 'collisions': 8}, {'tx': 14, 'success': 6, 'collisions': 8}, {'tx': 10, 'success': 3, 'collisions': 7}, {'tx': 8, 'success': 3, 'collisions': 5}, {'tx': 7, 'success': 2, 'collisions': 5}, {'tx': 11, 'success': 4, 'collisions': 7}, {'tx': 14, 'success': 6, 'collisions': 8}, {'tx': 4, 'success': 0, 'collisions': 4}, {'tx': 9, 'success': 1, 'collisions': 8}, {'tx': 4, 'success': 0, 'collisions': 4}, {'tx': 12, 'success': 6, 'collisions': 6}, {'tx': 4, 'success': 0, 'collisions': 4}, {'tx': 4, 'success': 0, 'collisions': 4}, {'tx': 4, 'success': 0, 'collisions': 4}, {'tx': 10, 'success': 4, 'collisions': 6}, {'tx': 10, 'success': 4, 'collisions': 6}, {'tx': 5, 'success': 0, 'collisions': 5}]"
164,30,65,261,92,169,0.6475095785440613,0.3524904214559387,0.598,"[{'tx': 7, 'success': 1, 'collisions': 6}, {'tx': 8, 'success': 2, 'collisions': 6}, {'tx': 10, 'success': 2, 'collisions': 8}, {'tx': 4, 'success': 0, 'collisions': 4}, {'tx': 13, 'success': 6, 'collisions': 7}, {'tx': 9, 'success': 4, 'collisions': 5}, {'tx': 8, 'success': 2, 'collisions': 6}, {'tx': 4, 'success': 0, 'collisions': 4}, {'tx': 14, 'success': 7, 'collisions': 7}, {'tx': 4, 'success': 0, 'collisions': 4}, {'tx': 8, 'success': 3, 'collisions': 5}, {'tx': 6, 'success': 1, 'collisions': 5}, {'tx': 8, 'success': 3, 'collisions': 5}, {'tx': 8, 'success': 2, 'collisions': 6}, {'tx': 16, 'success': 7, 'collisions': 9}, {'tx': 9, 'success': 3, 'collisions': 6}, {'tx': 10, 'success': 3, 'collisions': 7}, {'tx': 14, 'success': 7, 'collisions': 7}, {'tx': 9, 'success': 3, 'collisions': 6}, {'tx': 8, 'success': 4, 'collisions': 4}, {'tx': 7, 'success': 2, 'collisions': 5}, {'tx': 5, 'success': 1, 'collisions': 4}, {'tx': 4, 'success': 0, 'collisions': 4}, {'tx': 7, 'success': 2, 'collisions': 5}, {'tx': 15, 'success': 7, 'collisions': 8}, {'tx': 12, 'success': 7, 'collisions': 5}, {'tx': 4, 'success': 0, 'collisions': 4}, {'tx': 7, 'success': 2, 'collisions': 5}, {'tx': 12, 'success': 6, 'collisions': 6}, {'tx': 11, 'success': 5, 'collisions': 6}]"
165,30,66,260,80,180,0.6923076923076923,0.3076923076923077,0.528,"[{'tx': 4, 'success': 0, 'collisions': 4}, {'tx': 4, 'success': 0, 'collisions': 4}, {'tx': 15, 'success': 8, 'collisions': 7}, {'tx': 13, 'success': 4, 'collisions': 9}, {'tx': 5, 'success': 0, 'collisions': 5}, {'tx': 6, 'success': 1, 'collisions': 5}, {'tx': 9, 'success': 3, 'collisions': 6}, {'tx': 10, 'success': 4, 'collisions': 6}, {'tx': 13, 'success': 5, 'collisions': 8}, {'tx': 4, 'success': 0, 'collisions': 4}, {'tx': 6, 'success': 2, 'collisions': 4}, {'tx': 16, 'success': 7, 'collisions': 9}, {'tx': 10, 'success': 3, 'collisions': 7}, {'tx': 9, 'success': 4, 'collisions': 5}, {'tx': 4, 'success': 0, 'collisions': 4}, {'tx': 11, 'success': 5, 'collisions': 6}, {'tx': 4, 'success': 0, 'collisions': 4}, {'tx': 12, 'success': 5, 'collisions': 7}, {'tx': 12, 'success': 3, 'collisions': 9}, {'tx': 6, 'success': 0, 'collisions': 6}, {'tx': 16, 'success': 8, 'collisions': 8}, {'tx': 14, 'success': 5, 'collisions': 9}, {'tx': 5, 'success': 0, 'collisions': 5}, {'tx': 7, 'success': 1, 'collisions': 6}, {'tx': 7, 'success': 1, 'collisions': 6}, {'tx': 4, 'success': 0, 'collisions': 4}, {'tx': 8, 'success': 3, 'collisions': 5}, {'tx': 10, 'success': 3, 'collisions': 7}, {'tx': 9, 'success': 3, 'collisions': 6}, {'tx': 7, 'success': 2, 'collisions': 5}]"
166,30,67,259,80,179,0.6911196911196911,0.3088803088803089,0.536,"[{'tx': 15, 'success': 9, 'collisions': 6}, {'tx': 7, 'success': 2, 'collisions': 5}, {'tx': 8, 'success': 2, 'collisions': 6}, {'tx': 16, 'success': 10, 'collisions': 6}, {'tx': 9, 'success': 3, 'collisions': 6}, {'tx': 4, 'success': 0, 'collisions': 4}, {'tx': 13, 'success': 4, 'collisions': 9}, {'tx': 8, 'success': 1, 'collisions': 7}, {'tx': 5, 'success': 0, 'collisions': 5}, {'tx': 10, 'success': 4, 'collisions': 6}, {'tx': 10, 'success': 2, 'collisions': 8}, {'tx': 7, 'success': 1, 'collisions': 6}, {'tx': 10, 'success': 2, 'collisions': 8}, {'tx': 5, 'success': 0, 'collisions': 5}, {'tx': 10, 'success': 4, 'collisions': 6}, {'tx': 9, 'success': 3, 'collisions': 6}, {'tx': 7, 'success': 2, 'collisions': 5}, {'tx': 7, 'success': 3, 'collisions': 4}, {'tx': 5, 'success': 0, 'collisions': 5}, {'tx': 10, 'success': 4, 'collisions': 6}, {'tx': 5, 'success': 1, 'collisions': 4}, {'tx': 5, 'success': 0, 'collisions': 5}, {'tx': 11, 'success': 4, 'collisions': 7}, {'tx': 11, 'success': 4, 'collisions': 7}, {'tx': 4, 'success': 0, 'collisions': 4}, {'tx': 14, 'success': 6, 'collisions': 8}, {'tx': 8, 'success': 2, 'collisions': 6}, {'tx': 12, 'success': 5, 'collisions': 7}, {'tx': 7, 'success': 1, 'collisions': 6}, {'tx': 7, 'success': 1, 'collisions': 6}]"
167,30,68,242,80,162,0.6694214876033058,0.3305785123966942,0.544,"[{'tx': 11, 'success': 6, 'collisions': 5}, {'tx': 4, 'success': 0, 'collisions': 4}, {'tx': 4, 'success': 0, 'collisions': 4}, {'tx': 12, 'success': 8, 'collisions': 4}, {'tx': 9, 'success': 4, 'collisions': 5}, {'tx': 10, 'success': 4, 'collisions': 6}, {'tx': 12, 'success': 5, 'collisions': 7}, {'tx': 5, 'success': 1, 'collisions': 4}, {'tx': 4, 'success': 0, 'collisions': 4}, {'tx': 5, 'success': 1, 'collisions': 4}, {'tx': 14, 'success': 5, 'collisions': 9}, {'tx': 7, 'success': 2, 'collisions': 5}, {'tx': 5, 'success': 0, 'collisions': 5}, {'tx': 10, 'success': 4, 'collisions': 6}, {'tx': 12, 'success': 5, 'collisions': 7}, {'tx': 4, 'success': 0, 'collisions': 4}, {'tx': 9, 'success': 2, 'collisions': 7}, {'tx': 6, 'success': 2, 'collisions': 4}, {'tx': 9, 'success': 3, 'collisions': 6}, {'tx': 8, 'success': 2, 'collisions': 6}, {'tx': 9, 'success': 3, 'collisions': 6}, {'tx': 14, 'success': 7, 'collisions': 7}, {'tx': 6, 'success': 1, 'collisions': 5}, {'tx': 4, 'success': 0, 'collisions': 4}, {'tx': 4, 'success': 0, 'collisions': 4}, {'tx': 6, 'success': 2, 'collisions': 4}, {'tx': 4, 'success': 0, 'collisions': 4}, {'tx': 10, 'success': 3, 'collisions': 7}, {'tx': 12, 'success': 5, 'collisions': 7}, {'tx': 13, 'success': 5, 'collisions': 8}]"
168,30,69,256,72,184,0.71875,0.28125,0.4968,"[{'tx': 10, 'success': 3, 'collisions': 7}, {'tx': 6, 'success': 0, 'collisions': 6}, {'tx': 13, 'success': 5, 'collisions': 8}, {'tx': 6, 'success': 1, 'collisions': 5}, {'tx': 14, 'success': 6, 'collisions': 8}, {'tx': 4, 'success': 1, 'collisions': 3}, {'tx': 7, 'success': 1, 'collisions': 6}, {'tx': 4, 'success': 0, 'collisions': 4}, {'tx': 13, 'success': 5, 'collisions': 8}, {'tx': 9, 'success': 3, 'collisions': 6}, {'tx': 8, 'success': 3, 'collisions': 5}, {'tx': 11, 'success': 4, 'collisions': 7}, {'tx': 15, 'success': 7, 'collisions': 8}, {'tx': 4, 'success': 0, 'collisions': 4}, {'tx': 7, 'success': 1, 'collisions': 6}, {'tx': 12, 'success': 3, 'collisions': 9}, {'tx': 11, 'success': 4, 'collisions': 7}, {'tx': 14, 'success': 5, 'collisions': 9}, {'tx': 4, 'success': 0, 'collisions': 4}, {'tx': 9, 'success': 3, 'collisions': 6}, {'tx': 10, 'success': 3, 'collisions': 7}, {'tx': 4, 'success': 0, 'collisions': 4}, {'tx': 12, 'success': 4, 'collisions': 8}, {'tx': 7, 'success': 2, 'collisions': 5}, {'tx': 6, 'success': 1, 'collisions': 5}, {'tx': 8, 'success': 1, 'collisions': 7}, {'tx': 11, 'success': 3, 'collisions': 8}, {'tx': 6, 'success': 1, 'collisions': 5}, {'tx': 7, 'success': 1, 'collisions': 6}, {'tx': 4, 'success': 1, 'collisions': 3}]"
169,30,70,241,74,167,0.6929460580912863,0.3070539419087137,0.518,"[{'tx': 11, 'success': 5, 'collisions': 6}, {'tx': 7, 'success': 2, 'collisions': 5}, {'tx': 4, 'success': 0, 'collisions': 4}, {'tx': 8, 'success': 2, 'collisions': 6}, {'tx': 4, 'success': 0, 'collisions': 4}, {'tx': 12, 'success': 6, 'collisions': 6}, {'tx': 14, 'success': 6, 'collisions': 8}, {'tx': 6, 'success': 1, 'collisions': 5}, {'tx': 4, 'success': 0, 'collisions': 4}, {'tx': 10, 'success': 3, 'collisions': 7}, {'tx': 4, 'success': 0, 'collisions': 4}, {'tx': 7, 'success': 2, 'collisions': 5}, {'tx': 4, 'success': 0, 'collisions': 4}, {'tx': 7, 'success': 2, 'collisions': 5}, {'tx': 11, 'success': 4, 'collisions': 7}, {'tx': 5, 'success': 0, 'collisions': 5}, {'tx': 7, 'success': 3, 'collisions': 4}, {'tx': 11, 'success': 3, 'collisions': 8}, {'tx': 13, 'success': 7, 'collisions': 6}, {'tx': 6, 'success': 1, 'collisions': 5}, {'tx': 13, 'success': 8, 'collisions': 5}, {'tx': 7, 'success': 2, 'collisions': 5}, {'tx': 9, 'success': 3, 'collisions': 6}, {'tx': 9, 'success': 2, 'collisions': 7}, {'tx': 4, 'success': 0, 'collisions': 4}, {'tx': 7, 'success': 1, 'collisions': 6}, {'tx': 13, 'success': 4, 'collisions': 9}, {'tx': 9, 'success': 3, 'collisions': 6}, {'tx': 8, 'success': 3, 'collisions': 5}, {'tx': 7, 'success': 1, 'collisions': 6}]"
170,30,71,240,74,166,0.6916666666666667,0.30833333333333335,0.5254,"[{'tx': 4, 'success': 0, 'collisions': 4}, {'tx': 8, 'success': 2, 'collisions': 6}, {'tx': 13, 'success': 6, 'collisions': 7}, {'tx': 4, 'success': 0, 'collisions': 4}, {'tx': 4, 'success': 0, 'collisions': 4}, {'tx': 4, 'success': 0, 'collisions': 4}, {'tx': 11, 'success': 5, 'collisions': 6}, {'tx': 15, 'success': 6, 'collisions': 9}, {'tx': 9, 'success': 3, 'collisions': 6}, {'tx': 7, 'success': 2, 'collisions': 5}, {'tx': 10, 'success': 3, 'collisions': 7}, {'tx': 15, 'success': 7, 'collisions': 8}, {'tx': 8, 'success': 3, 'collisions': 5}, {'tx': 12, 'success': 5, 'collisions': 7}, {'tx': 4, 'success': 0, 'collisions': 4}, {'tx': 4, 'success': 0, 'collisions': 4}, {'tx': 5, 'success': 0, 'collisions': 5}, {'tx': 7, 'success': 2, 'collisions': 5}, {'tx': 4, 'success': 0, 'collisions': 4}, {'tx': 11, 'success': 4, 'collisions': 7}, {'tx': 13, 'success': 6, 'collisions': 7}, {'tx': 6, 'success': 1, 'collisions': 5}, {'tx': 8, 'success': 1, 'collisions': 7}, {'tx': 9, 'success': 4, 'collisions': 5}, {'tx': 13, 'success': 7, 'collisions': 6}, {'tx': 11, 'success': 5, 'collisions': 6}, {'tx': 5, 'success': 0, 'collisions': 5}, {'tx': 5, 'success': 1, 'collisions': 4}, {'tx': 7, 'success': 1, 'collisions': 6}, {'tx': 4, 'success': 0, 'collisions': 4}]"
171,30,72,246,71,175,0.7113821138211383,0.2886178861788618,0.5112,"[{'tx': 4, 'success': 0, 'collisions': 4}, {'tx': 7, 'success': 1, 'collisions': 6}, {'tx': 6, 'success': 1, 'collisions': 5}, {'tx': 4, 'success': 0, 'collisions': 4}, {'tx': 7, 'success': 1, 'collisions': 6}, {'tx': 7, 'success': 1, 'collisions': 6}, {'tx': 7, 'success': 2, 'collisions': 5}, {'tx': 4, 'success': 0, 'collisions': 4}, {'tx': 15, 'success': 6, 'collisions': 9}, {'tx': 8, 'success': 2, 'collisions': 6}, {'tx': 9, 'success': 3, 'collisions': 6}, {'tx': 11, 'success': 4, 'collisions': 7}, {'tx': 9, 'success': 3, 'collisions': 6}, {'tx': 9, 'success': 3, 'collisions': 6}, {'tx': 12, 'success': 6, 'collisions': 6}, {'tx': 4, 'success': 0, 'collisions': 4}, {'tx': 14, 'success': 6, 'collisions': 8}, {'tx': 7, 'success': 1, 'collisions': 6}, {'tx': 6, 'success': 1, 'collisions': 5}, {'tx': 4, 'success': 0, 'collisions': 4}, {'tx': 9, 'success': 4, 'collisions': 5}, {'tx': 12, 'success': 5, 'collisions': 7}, {'tx': 10, 'success': 3, 'collisions': 7}, {'tx': 9, 'success': 5, 'collisions': 4}, {'tx': 4, 'success': 0, 'collisions': 4}, {'tx': 16, 'success': 6, 'collisions': 10}, {'tx': 5, 'success': 0, 'collisions': 5}, {'tx': 4, 'success': 0, 'collisions': 4}, {'tx': 7, 'success': 2, 'collisions': 5}, {'tx': 16, 'success': 5, 'collisions': 11}]"
172,30,73,238,74,164,0.6890756302521008,0.31092436974789917,0.5402,"[{'tx': 8, 'success': 3, 'collisions': 5}, {'tx': 10, 'success': 3, 'collisions': 7}, {'tx': 9, 'success': 3, 'collisions': 6}, {'tx': 7, 'success': 2, 'collisions': 5}, {'tx': 4, 'success': 0, 'collisions': 4}, {'tx': 6, 'success': 1, 'collisions': 5}, {'tx': 6, 'success': 1, 'collisions': 5}, {'tx': 17, 'success': 11, 'collisions': 6}, {'tx': 5, 'success': 1, 'collisions': 4}, {'tx': 4, 'success': 0, 'collisions': 4}, {'tx': 9, 'success': 2, 'collisions': 7}, {'tx': 14, 'success': 5, 'collisions': 9}, {'tx': 7, 'success': 1, 'collisions': 6}, {'tx': 4, 'success': 0, 'collisions': 4}, {'tx': 8, 'success': 2, 'collisions': 6}, {'tx': 4, 'success': 0, 'collisions': 4}, {'tx': 4, 'success': 0, 'collisions': 4}, {'tx': 13, 'success': 6, 'collisions': 7}, {'tx': 11, 'success': 4, 'collisions': 7}, {'tx': 4, 'success': 0, 'collisions': 4}, {'tx': 7, 'success': 2, 'collisions': 5}, {'tx': 15, 'success': 8, 'collisions': 7}, {'tx': 4, 'success': 0, 'collisions': 4}, {'tx': 13, 'success': 6, 'collisions': 7}, {'tx': 4, 'success': 0, 'collisions': 4}, {'tx': 4, 'success': 0, 'collisions': 4}, {'tx': 16, 'success': 8, 'collisions': 8}, {'tx': 4, 'success': 0, 'collisions': 4}, {'tx': 7, 'success': 2, 'collisions': 5}, {'tx': 10, 'success': 3, 'collisions': 7}]"
173,30,74,238,69,169,0.7100840336134454,0.28991596638655465,0.5106,"[{'tx': 11, 'success': 4, 'collisions': 7}, {'tx': 12, 'success': 4, 'collisions': 8}, {'tx': 13, 'success': 7, 'collisions': 6}, {'tx': 4, 'success': 0, 'collisions': 4}, {'tx': 14, 'success': 6, 'collisions': 8}, {'tx': 13, 'success': 4, 'collisions': 9}, {'tx': 9, 'success': 2, 'collisions': 7}, {'tx': 10, 'success': 4, 'collisions': 6}, {'tx': 5, 'success': 1, 'collisions': 4}, {'tx': 12, 'success': 6, 'collisions': 6}, {'tx': 5, 'success': 0, 'collisions': 5}, {'tx': 7, 'success': 1, 'collisions': 6}, {'tx': 4, 'success': 0, 'collisions': 4}, {'tx': 10, 'success': 4, 'collisions': 6}, {'tx': 4, 'success': 0, 'collisions': 4}, {'tx': 8, 'success': 3, 'collisions': 5}, {'tx': 8, 'success': 2, 'collisions': 6}, {'tx': 4, 'success': 0, 'collisions': 4}, {'tx': 4, 'success': 0, 'collisions': 4}, {'tx': 11, 'success': 4, 'collisions': 7}, {'tx': 4, 'success': 0, 'collisions': 4}, {'tx': 9, 'success': 2, 'collisions': 7}, {'tx': 4, 'success': 0, 'collisions': 4}, {'tx': 10, 'success': 3, 'collisions': 7}, {'tx': 9, 'success': 3, 'collisions': 6}, {'tx': 9, 'success': 3, 'collisions': 6}, {'tx': 4, 'success': 0, 'collisions': 4}, {'tx': 5, 'success': 0, 'collisions': 5}, {'tx': 12, 'success': 6, 'collisions': 6}, {'tx': 4, 'success': 0, 'collisions': 4}]"
174,30,75,233,65,168,0.721030042918455,0.27896995708154504,0.4875,"[{'tx': 5, 'success': 1, 'collisions': 4}, {'tx': 12, 'success': 4, 'collisions': 8}, {'tx': 6, 'success': 1, 'collisions': 5}, {'tx': 4, 'success': 0, 'collisions': 4}, {'tx': 8, 'success': 1, 'collisions': 7}, {'tx': 15, 'success': 8, 'collisions': 7}, {'tx': 8, 'success': 2, 'collisions': 6}, {'tx': 9, 'success': 3, 'collisions': 6}, {'tx': 10, 'success': 3, 'collisions': 7}, {'tx': 5, 'success': 0, 'collisions': 5}, {'tx': 4, 'success': 0, 'collisions': 4}, {'tx': 4, 'success': 0, 'collisions': 4}, {'tx': 4, 'success': 0, 'collisions': 4}, {'tx': 14, 'success': 6, 'collisions': 8}, {'tx': 5, 'success': 1, 'collisions': 4}, {'tx': 7, 'success': 2, 'collisions': 5}, {'tx': 5, 'success': 1, 'collisions': 4}, {'tx': 4, 'success': 0, 'collisions': 4}, {'tx': 7, 'success': 1, 'collisions': 6}, {'tx': 6, 'success': 2, 'collisions': 4}, {'tx': 16, 'success': 7, 'collisions': 9}, {'tx': 14, 'success': 6, 'collisions': 8}, {'tx': 9, 'success': 3, 'collisions': 6}, {'tx': 6, 'success': 2, 'collisions': 4}, {'tx': 4, 'success': 0, 'collisions': 4}, {'tx': 8, 'success': 3, 'collisions': 5}, {'tx': 7, 'success': 1, 'collisions': 6}, {'tx': 4, 'success': 0, 'collisions': 4}, {'tx': 12, 'success': 4, 'collisions': 8}, {'tx': 11, 'success': 3, 'collisions': 8}]"
175,30,76,230,69,161,0.7,0.3,0.5244,"[{'tx': 9, 'success': 3, 'collisions': 6}, {'tx': 5, 'success': 0, 'collisions': 5}, {'tx': 4, 'success': 0, 'collisions': 4}, {'tx': 5, 'success': 0, 'collisions': 5}, {'tx': 7, 'success': 2, 'collisions': 5}, {'tx': 11, 'success': 5, 'collisions': 6}, {'tx': 14, 'success': 6, 'collisions': 8}, {'tx': 5, 'success': 1, 'collisions': 4}, {'tx': 4, 'success': 0, 'collisions': 4}, {'tx': 4, 'success': 0, 'collisions': 4}, {'tx': 9, 'success': 2, 'collisions': 7}, {'tx': 12, 'success': 7, 'collisions': 5}, {'tx': 4, 'success': 0, 'collisions': 4}, {'tx': 6, 'success': 1, 'collisions': 5}, {'tx': 4, 'success': 0, 'collisions': 4}, {'tx': 10, 'success': 2, 'collisions': 8}, {'tx': 7, 'success': 1, 'collisions': 6}, {'tx': 8, 'success': 3, 'collisions': 5}, {'tx': 4, 'success': 0, 'collisions': 4}, {'tx': 15, 'success': 9, 'collisions': 6}, {'tx': 4, 'success': 0, 'collisions': 4}, {'tx': 15, 'success': 6, 'collisions': 9}, {'tx': 11, 'success': 4, 'collisions': 7}, {'tx': 9, 'success': 3, 'collisions': 6}, {'tx': 4, 'success': 0, 'collisions': 4}, {'tx': 4, 'success': 0, 'collisions': 4}, {'tx': 14, 'success': 5, 'collisions': 9}, {'tx': 4, 'success': 0, 'collisions': 4}, {'tx': 13, 'success': 8, 'collisions': 5}, {'tx': 5, 'success': 1, 'collisions': 4}]"
176,30,77,234,72,162,0.6923076923076923,0.3076923076923077,0.5544,"[{'tx': 8, 'success': 2, 'collisions': 6}, {'tx': 4, 'success': 0, 'collisions': 4}, {'tx': 6, 'success': 2, 'collisions': 4}, {'tx': 8, 'success': 3, 'collisions': 5}, {'tx': 7, 'success': 2, 'collisions': 5}, {'tx': 6, 'success': 1, 'collisions': 5}, {'tx': 8, 'success': 1, 'collisions': 7}, {'tx': 6, 'success': 1, 'collisions': 5}, {'tx': 14, 'success': 6, 'collisions': 8}, {'tx': 10, 'success': 4, 'collisions': 6}, {'tx': 5, 'success': 0, 'collisions': 5}, {'tx': 12, 'success': 5, 'collisions': 7}, {'tx': 17, 'success': 8, 'collisions': 9}, {'tx': 4, 'success': 0, 'collisions': 4}, {'tx': 4, 'success': 0, 'collisions': 4}, {'tx': 4, 'success': 0, 'collisions': 4}, {'tx': 8, 'success': 2, 'collisions': 6}, {'tx': 12, 'success': 7, 'collisions': 5}, {'tx': 13, 'success': 7, 'collisions': 6}, {'tx': 9, 'success': 4, 'collisions': 5}, {'tx': 5, 'success': 1, 'collisions': 4}, {'tx': 12, 'success': 4, 'collisions': 8}, {'tx': 9, 'success': 3, 'collisions': 6}, {'tx': 5, 'success': 1, 'collisions': 4}, {'tx': 9, 'success': 3, 'collisions': 6}, {'tx': 5, 'success': 1, 'collisions': 4}, {'tx': 6, 'success': 2, 'collisions': 4}, {'tx': 9, 'success': 1, 'collisions': 8}, {'tx': 5, 'success': 1, 'collisions': 4}, {'tx': 4, 'success': 0, 'collisions': 4}]"
177,30,78,218,71,147,0.6743119266055045,0.3256880733944954,0.5538,"[{'tx': 7, 'success': 2, 'collisions': 5}, {'tx': 4, 'success': 0, 'collisions': 4}, {'tx': 4, 'success': 0, 'collisions': 4}, {'tx': 5, 'success': 1, 'collisions': 4}, {'tx': 7, 'success': 1, 'collisions': 6}, {'tx': 5, 'success': 0, 'collisions': 5}, {'tx': 6, 'success': 2, 'collisions': 4}, {'tx': 4, 'success': 0, 'collisions': 4}, {'tx': 12, 'success': 5, 'collisions': 7}, {'tx': 9, 'success': 4, 'collisions': 5}, {'tx': 6, 'success': 2, 'collisions': 4}, {'tx': 3, 'success': 0, 'collisions': 3}, {'tx': 3, 'success': 0, 'collisions': 3}, {'tx': 7, 'success': 1, 'collisions': 6}, {'tx': 7, 'success': 2, 'collisions': 5}, {'tx': 4, 'success': 1, 'collisions': 3}, {'tx': 13, 'success': 6, 'collisions': 7}, {'tx': 8, 'success': 3, 'collisions': 5}, {'tx': 9, 'success': 3, 'collisions': 6}, {'tx': 8, 'success': 3, 'collisions': 5}, {'tx': 9, 'success': 3, 'collisions': 6}, {'tx': 4, 'success': 0, 'collisions': 4}, {'tx': 12, 'success': 7, 'collisions': 5}, {'tx': 11, 'success': 6, 'collisions': 5}, {'tx': 7, 'success': 2, 'collisions': 5}, {'tx': 10, 'success': 5, 'collisions': 5}, {'tx': 5, 'success': 0, 'collisions': 5}, {'tx': 12, 'success': 7, 'collisions': 5}, {'tx': 5, 'success': 1, 'collisions': 4}, {'tx': 12, 'success': 4, 'collisions': 8}]"
178,30,79,214,69,145,0.677570093457944,0.32242990654205606,0.5451,"[{'tx': 10, 'success': 3, 'collisions': 7}, {'tx': 12, 'success': 7, 'collisions': 5}, {'tx': 5, 'success': 1, 'collisions': 4}, {'tx': 3, 'success': 0, 'collisions': 3}, {'tx': 7, 'success': 1, 'collisions': 6}, {'tx': 6, 'success': 2, 'collisions': 4}, {'tx': 4, 'success': 0, 'collisions': 4}, {'tx': 4, 'success': 0, 'collisions': 4}, {'tx': 6, 'success': 1, 'collisions': 5}, {'tx': 12, 'success': 4, 'collisions': 8}, {'tx': 4, 'success': 0, 'collisions': 4}, {'tx': 9, 'success': 5, 'collisions': 4}, {'tx': 4, 'success': 0, 'collisions': 4}, {'tx': 11, 'success': 4, 'collisions': 7}, {'tx': 3, 'success': 0, 'collisions': 3}, {'tx': 4, 'success': 1, 'collisions': 3}, {'tx': 4, 'success': 0, 'collisions': 4}, {'tx': 10, 'success': 4, 'collisions': 6}, {'tx': 8, 'success': 4, 'collisions': 4}, {'tx': 8, 'success': 1, 'collisions': 7}, {'tx': 4, 'success': 0, 'collisions': 4}, {'tx': 5, 'success': 1, 'collisions': 4}, {'tx': 10, 'success': 3, 'collisions': 7}, {'tx': 14, 'success': 6, 'collisions': 8}, {'tx': 13, 'success': 8, 'collisions': 5}, {'tx': 4, 'success': 0, 'collisions': 4}, {'tx': 3, 'success': 0, 'collisions': 3}, {'tx': 11, 'success': 6, 'collisions': 5}, {'tx': 13, 'success': 7, 'collisions': 6}, {'tx': 3, 'success': 0, 'collisions': 3}]"
179,30,80,221,67,154,0.6968325791855203,0.3031674208144796,0.536,"[{'tx': 4, 'success': 0, 'collisions': 4}, {'tx': 5, 'success': 0, 'collisions': 5}, {'tx': 7, 'success': 3, 'collisions': 4}, {'tx': 9, 'success': 3, 'collisions': 6}, {'tx': 11, 'success': 6, 'collisions': 5}, {'tx': 10, 'success': 4, 'collisions': 6}, {'tx': 14, 'success': 5, 'collisions': 9}, {'tx': 6, 'success': 1, 'collisions': 5}, {'tx': 7, 'success': 2, 'collisions': 5}, {'tx': 7, 'success': 2, 'collisions': 5}, {'tx': 16, 'success': 8, 'collisions': 8}, {'tx': 4, 'success': 0, 'collisions': 4}, {'tx': 5, 'success': 1, 'collisions': 4}, {'tx': 10, 'success': 5, 'collisions': 5}, {'tx': 10, 'success': 4, 'collisions': 6}, {'tx': 7, 'success': 2, 'collisions': 5}, {'tx': 5, 'success': 1, 'collisions': 4}, {'tx': 18, 'success': 11, 'collisions': 7}, {'tx': 8, 'success': 2, 'collisions': 6}, {'tx': 4, 'success': 0, 'collisions': 4}, {'tx': 4, 'success': 0, 'collisions': 4}, {'tx': 8, 'success': 1, 'collisions': 7}, {'tx': 7, 'success': 2, 'collisions': 5}, {'tx': 8, 'success': 2, 'collisions': 6}, {'tx': 4, 'success': 0, 'collisions': 4}, {'tx': 3, 'success': 0, 'collisions': 3}, {'tx': 4, 'success': 0, 'collisions': 4}, {'tx': 6, 'success': 1, 'collisions': 5}, {'tx': 4, 'success': 0, 'collisions': 4}, {'tx': 6, 'success': 1, 'collisions': 5}]"
180,30,81,213,60,153,0.7183098591549296,0.28169014084507044,0.486,"[{'tx': 10, 'success': 5, 'collisions': 5}, {'tx': 7, 'success': 1, 'collisions': 6}, {'tx': 4, 'success': 0, 'collisions': 4}, {'tx': 6, 'success': 1, 'collisions': 5}, {'tx': 6, 'success': 1, 'collisions': 5}, {'tx': 5, 'success': 1, 'collisions': 4}, {'tx': 13, 'success': 5, 'collisions': 8}, {'tx': 10, 'success': 3, 'collisions': 7}, {'tx': 17, 'success': 10, 'collisions': 7}, {'tx': 6, 'success': 1, 'collisions': 5}, {'tx': 4, 'success': 0, 'collisions': 4}, {'tx': 6, 'success': 1, 'collisions': 5}, {'tx': 4, 'success': 1, 'collisions': 3}, {'tx': 8, 'success': 3, 'collisions': 5}, {'tx': 3, 'success': 0, 'collisions': 3}, {'tx': 10, 'success': 3, 'collisions': 7}, {'tx': 6, 'success': 1, 'collisions': 5}, {'tx': 9, 'success': 2, 'collisions': 7}, {'tx': 8, 'success': 1, 'collisions': 7}, {'tx': 7, 'success': 2, 'collisions': 5}, {'tx': 7, 'success': 3, 'collisions': 4}, {'tx': 3, 'success': 0, 'collisions': 3}, {'tx': 4, 'success': 0, 'collisions': 4}, {'tx': 4, 'success': 0, 'collisions': 4}, {'tx': 5, 'success': 1, 'collisions': 4}, {'tx': 9, 'success': 4, 'collisions': 5}, {'tx': 10, 'success': 3, 'collisions': 7}, {'tx': 8, 'success': 3, 'collisions': 5}, {'tx': 6, 'success': 2, 'collisions': 4}, {'tx': 8, 'success': 2, 'collisions': 6}]"
181,30,82,217,64,153,0.7050691244239631,0.29493087557603687,0.5248,"[{'tx': 4, 'success': 0, 'collisions': 4}, {'tx': 4, 'success': 0, 'collisions': 4}, {'tx': 7, 'success': 2, 'collisions': 5}, {'tx': 3, 'success': 0, 'collisions': 3}, {'tx': 7, 'success': 2, 'collisions': 5}, {'tx': 4, 'success': 0, 'collisions': 4}, {'tx': 8, 'success': 2, 'collisions': 6}, {'tx': 8, 'success': 3, 'collisions': 5}, {'tx': 11, 'success': 5, 'collisions': 6}, {'tx': 4, 'success': 0, 'collisions': 4}, {'tx': 9, 'success': 3, 'collisions': 6}, {'tx': 4, 'success': 0, 'collisions': 4}, {'tx': 7, 'success': 2, 'collisions': 5}, {'tx': 7, 'success': 3, 'collisions': 4}, {'tx': 6, 'success': 1, 'collisions': 5}, {'tx': 6, 'success': 1, 'collisions': 5}, {'tx': 10, 'success': 4, 'collisions': 6}, {'tx': 6, 'success': 0, 'collisions': 6}, {'tx': 7, 'success': 1, 'collisions': 6}, {'tx': 7, 'success': 3, 'collisions': 4}, {'tx': 10, 'success': 4, 'collisions': 6}, {'tx': 10, 'success': 3, 'collisions': 7}, {'tx': 12, 'success': 5, 'collisions': 7}, {'tx': 8, 'success': 2, 'collisions': 6}, {'tx': 8, 'success': 2, 'collisions': 6}, {'tx': 9, 'success': 4, 'collisions': 5}, {'tx': 9, 'success': 3, 'collisions': 6}, {'tx': 7, 'success': 3, 'collisions': 4}, {'tx': 11, 'success': 6, 'collisions': 5}, {'tx': 4, 'success': 0, 'collisions': 4}]"
182,30,83,216,60,156,0.7222222222222222,0.2777777777777778,0.498,"[{'tx': 6, 'success': 2, 'collisions': 4}, {'tx': 10, 'success': 4, 'collisions': 6}, {'tx': 10, 'success': 3, 'collisions': 7}, {'tx': 10, 'success': 4, 'collisions': 6}, {'tx': 10, 'success': 5, 'collisions': 5}, {'tx': 5, 'success': 2, 'collisions': 3}, {'tx': 7, 'success': 2, 'collisions': 5}, {'tx': 8, 'success': 2, 'collisions': 6}, {'tx': 6, 'success': 1, 'collisions': 5}, {'tx': 6, 'success': 1, 'collisions': 5}, {'tx': 7, 'success': 2, 'collisions': 5}, {'tx': 4, 'success': 0, 'collisions': 4}, {'tx': 4, 'success': 0, 'collisions': 4}, {'tx': 8, 'success': 4, 'collisions': 4}, {'tx': 11, 'success': 4, 'collisions': 7}, {'tx': 3, 'success': 0, 'collisions': 3}, {'tx': 9, 'success': 4, 'collisions': 5}, {'tx': 6, 'success': 1, 'collisions': 5}, {'tx': 4, 'success': 0, 'collisions': 4}, {'tx': 6, 'success': 1, 'collisions': 5}, {'tx': 15, 'success': 6, 'collisions': 9}, {'tx': 13, 'success': 3, 'collisions': 10}, {'tx': 8, 'success': 2, 'collisions': 6}, {'tx': 7, 'success': 1, 'collisions': 6}, {'tx': 5, 'success': 1, 'collisions': 4}, {'tx': 4, 'success': 0, 'collisions': 4}, {'tx': 11, 'success': 4, 'collisions': 7}, {'tx': 7, 'success': 1, 'collisions': 6}, {'tx': 3, 'success': 0, 'collisions': 3}, {'tx': 3, 'success': 0, 'collisions': 3}]"
183,30,84,209,56,153,0.7320574162679426,0.2679425837320574,0.4704,"[{'tx': 7, 'success': 2, 'collisions': 5}, {'tx': 5, 'success': 0, 'collisions': 5}, {'tx': 5, 'success': 0, 'collisions': 5}, {'tx': 9, 'success': 4, 'collisions': 5}, {'tx': 4, 'success': 1, 'collisions': 3}, {'tx': 11, 'success': 4, 'collisions': 7}, {'tx': 9, 'success': 4, 'collisions': 5}, {'tx': 9, 'success': 2, 'collisions': 7}, {'tx': 6, 'success': 2, 'collisions': 4}, {'tx': 4, 'success': 0, 'collisions': 4}, {'tx': 4, 'success': 0, 'collisions': 4}, {'tx': 8, 'success': 2, 'collisions': 6}, {'tx': 11, 'success': 2, 'collisions': 9}, {'tx': 10, 'success': 3, 'collisions': 7}, {'tx': 8, 'success': 3, 'collisions': 5}, {'tx': 3, 'success': 0, 'collisions': 3}, {'tx': 5, 'success': 0, 'collisions': 5}, {'tx': 11, 'success': 6, 'collisions': 5}, {'tx': 4, 'success': 0, 'collisions': 4}, {'tx': 12, 'success': 6, 'collisions': 6}, {'tx': 7, 'success': 2, 'collisions': 5}, {'tx': 6, 'success': 2, 'collisions': 4}, {'tx': 6, 'success': 1, 'collisions': 5}, {'tx': 7, 'success': 1, 'collisions': 6}, {'tx': 5, 'success': 0, 'collisions': 5}, {'tx': 10, 'success': 4, 'collisions': 6}, {'tx': 4, 'success': 0, 'collisions': 4}, {'tx': 5, 'success': 1, 'collisions': 4}, {'tx': 5, 'success': 1, 'collisions': 4}, {'tx': 9, 'success': 3, 'collisions': 6}]"
184,30,85,208,60,148,0.7115384615384616,0.28846153846153844,0.51,"[{'tx': 4, 'success': 0, 'collisions': 4}, {'tx': 3, 'success': 0, 'collisions': 3}, {'tx': 4, 'success': 0, 'collisions': 4}, {'tx': 12, 'success': 6, 'collisions': 6}, {'tx': 9, 'success': 2, 'collisions': 7}, {'tx': 3, 'success': 0, 'collisions': 3}, {'tx': 5, 'success': 1, 'collisions': 4}, {'tx': 12, 'success': 5, 'collisions': 7}, {'tx': 6, 'success': 1, 'collisions': 5}, {'tx': 6, 'success': 2, 'collisions': 4}, {'tx': 14, 'success': 8, 'collisions': 6}, {'tx': 12, 'success': 5, 'collisions': 7}, {'tx': 6, 'success': 1, 'collisions': 5}, {'tx': 4, 'success': 0, 'collisions': 4}, {'tx': 9, 'success': 4, 'collisions': 5}, {'tx': 14, 'success': 6, 'collisions': 8}, {'tx': 4, 'success': 0, 'collisions': 4}, {'tx': 8, 'success': 3, 'collisions': 5}, {'tx': 4, 'success': 0, 'collisions': 4}, {'tx': 12, 'success': 6, 'collisions': 6}, {'tx': 6, 'success': 1, 'collisions': 5}, {'tx': 7, 'success': 2, 'collisions': 5}, {'tx': 5, 'success': 1, 'collisions': 4}, {'tx': 6, 'success': 0, 'collisions': 6}, {'tx': 7, 'success': 1, 'collisions': 6}, {'tx': 4, 'success': 0, 'collisions': 4}, {'tx': 4, 'success': 0, 'collisions': 4}, {'tx': 4, 'success': 0, 'collisions': 4}, {'tx': 4, 'success': 0, 'collisions': 4}, {'tx': 10, 'success': 5, 'collisions': 5}]"
185,30,86,210,56,154,0.7333333333333333,0.26666666666666666,0.4816,"[{'tx': 6, 'success': 0, 'collisions': 6}, {'tx': 9, 'success': 4, 'collisions': 5}, {'tx': 4, 'success': 1, 'collisions': 3}, {'tx': 7, 'success': 1, 'collisions': 6}, {'tx': 7, 'success': 2, 'collisions': 5}, {'tx': 4, 'success': 0, 'collisions': 4}, {'tx': 11, 'success': 4, 'collisions': 7}, {'tx': 4, 'success': 0, 'collisions': 4}, {'tx': 8, 'success': 3, 'collisions': 5}, {'tx': 6, 'success': 1, 'collisions': 5}, {'tx': 3, 'success': 0, 'collisions': 3}, {'tx': 4, 'success': 0, 'collisions': 4}, {'tx': 10, 'success': 2, 'collisions': 8}, {'tx': 8, 'success': 2, 'collisions': 6}, {'tx': 7, 'success': 3, 'collisions': 4}, {'tx': 9, 'success': 2, 'collisions': 7}, {'tx': 3, 'success': 0, 'collisions': 3}, {'tx': 10, 'success': 3, 'collisions': 7}, {'tx': 4, 'success': 0, 'collisions': 4}, {'tx': 8, 'success': 1, 'collisions': 7}, {'tx': 13, 'success': 4, 'collisions': 9}, {'tx': 5, 'success': 1, 'collisions': 4}, {'tx': 3, 'success': 0, 'collisions': 3}, {'tx': 12, 'success': 8, 'collisions': 4}, {'tx': 10, 'success': 3, 'collisions': 7}, {'tx': 4, 'success': 0, 'collisions': 4}, {'tx': 3, 'success': 0, 'collisions': 3}, {'tx': 7, 'success': 2, 'collisions': 5}, {'tx': 8, 'success': 3, 'collisions': 5}, {'tx': 13, 'success': 6, 'collisions': 7}]"
186,30,87,204,59,145,0.7107843137254902,0.28921568627450983,0.5133,"[{'tx': 4, 'success': 0, 'collisions': 4}, {'tx': 4, 'success': 0, 'collisions': 4}, {'tx': 13, 'success': 7, 'collisions': 6}, {'tx': 5, 'success': 1, 'collisions': 4}, {'tx': 12, 'success': 6, 'collisions': 6}, {'tx': 4, 'success': 0, 'collisions': 4}, {'tx': 4, 'success': 0, 'collisions': 4}, {'tx': 11, 'success': 6, 'collisions': 5}, {'tx': 13, 'success': 6, 'collisions': 7}, {'tx': 4, 'success': 0, 'collisions': 4}, {'tx': 9, 'success': 4, 'collisions': 5}, {'tx': 6, 'success': 1, 'collisions': 5}, {'tx': 10, 'success': 3, 'collisions': 7}, {'tx': 8, 'success': 2, 'collisions': 6}, {'tx': 11, 'success': 5, 'collisions': 6}, {'tx': 4, 'success': 0, 'collisions': 4}, {'tx': 9, 'success': 2, 'collisions': 7}, {'tx': 3, 'success': 0, 'collisions': 3}, {'tx': 10, 'success': 4, 'collisions': 6}, {'tx': 4, 'success': 1, 'collisions': 3}, {'tx': 4, 'success': 0, 'collisions': 4}, {'tx': 9, 'success': 2, 'collisions': 7}, {'tx': 8, 'success': 3, 'collisions': 5}, {'tx': 4, 'success': 0, 'collisions': 4}, {'tx': 9, 'success': 4, 'collisions': 5}, {'tx': 4, 'success': 0, 'collisions': 4}, {'tx': 4, 'success': 0, 'collisions': 4}, {'tx': 6, 'success': 2, 'collisions': 4}, {'tx': 4, 'success': 0, 'collisions': 4}, {'tx': 4, 'success': 0, 'collisions': 4}]"
187,30,88,202,60,142,0.7029702970297029,0.297029702970297,0.528,"[{'tx': 8, 'success': 3, 'collisions': 5}, {'tx': 10, 'success': 4, 'collisions': 6}, {'tx': 9, 'success': 4, 'collisions': 5}, {'tx': 9, 'success': 3, 'collisions': 6}, {'tx': 13, 'success': 8, 'collisions': 5}, {'tx': 4, 'success': 1, 'collisions': 3}, {'tx': 4, 'success': 0, 'collisions': 4}, {'tx': 11, 'success': 5, 'collisions': 6}, {'tx': 3, 'success': 0, 'collisions': 3}, {'tx': 10, 'success': 5, 'collisions': 5}, {'tx': 4, 'success': 0, 'collisions': 4}, {'tx': 4, 'success': 0, 'collisions': 4}, {'tx': 12, 'success': 3, 'collisions': 9}, {'tx': 3, 'success': 0, 'collisions': 3}, {'tx': 9, 'success': 3, 'collisions': 6}, {'tx': 7, 'success': 1, 'collisions': 6}, {'tx': 5, 'success': 0, 'collisions': 5}, {'tx': 8, 'success': 3, 'collisions': 5}, {'tx': 4, 'success': 0, 'collisions': 4}, {'tx': 6, 'success': 2, 'collisions': 4}, {'tx': 4, 'success': 0, 'collisions': 4}, {'tx': 4, 'success': 0, 'collisions': 4}, {'tx': 3, 'success': 0, 'collisions': 3}, {'tx': 7, 'success': 2, 'collisions': 5}, {'tx': 7, 'success': 2, 'collisions': 5}, {'tx': 11, 'success': 6, 'collisions': 5}, {'tx': 4, 'success': 0, 'collisions': 4}, {'tx': 8, 'success': 3, 'collisions': 5}, {'tx': 5, 'success': 1, 'collisions': 4}, {'tx': 6, 'success': 1, 'collisions': 5}]"
188,30,89,203,57,146,0.7192118226600985,0.28078817733990147,0.5073,"[{'tx': 4, 'success': 0, 'collisions': 4}, {'tx': 4, 'success': 0, 'collisions': 4}, {'tx': 6, 'success': 1, 'collisions': 5}, {'tx': 4, 'success': 0, 'collisions': 4}, {'tx': 5, 'success': 1, 'collisions': 4}, {'tx': 8, 'success': 3, 'collisions': 5}, {'tx': 7, 'success': 1, 'collisions': 6}, {'tx': 7, 'success': 1, 'collisions': 6}, {'tx': 9, 'success': 2, 'collisions': 7}, {'tx': 5, 'success': 1, 'collisions': 4}, {'tx': 6, 'success': 2, 'collisions': 4}, {'tx': 10, 'success': 4, 'collisions': 6}, {'tx': 8, 'success': 3, 'collisions': 5}, {'tx': 9, 'success': 4, 'collisions': 5}, {'tx': 12, 'success': 6, 'collisions': 6}, {'tx': 4, 'success': 0, 'collisions': 4}, {'tx': 4, 'success': 0, 'collisions': 4}, {'tx': 4, 'success': 0, 'collisions': 4}, {'tx': 8, 'success': 3, 'collisions': 5}, {'tx': 8, 'success': 4, 'collisions': 4}, {'tx': 11, 'success': 5, 'collisions': 6}, {'tx': 6, 'success': 1, 'collisions': 5}, {'tx': 5, 'success': 1, 'collisions': 4}, {'tx': 4, 'success': 0, 'collisions': 4}, {'tx': 9, 'success': 2, 'collisions': 7}, {'tx': 5, 'success': 1, 'collisions': 4}, {'tx': 10, 'success': 4, 'collisions': 6}, {'tx': 5, 'success': 1, 'collisions': 4}, {'tx': 12, 'success': 6, 'collisions': 6}, {'tx': 4, 'success': 0, 'collisions': 4}]"
189,30,90,209,52,157,0.7511961722488039,0.24880382775119617,0.468,"[{'tx': 6, 'success': 1, 'collisions': 5}, {'tx': 3, 'success': 0, 'collisions': 3}, {'tx': 5, 'success': 0, 'collisions': 5}, {'tx': 4, 'success': 0, 'collisions': 4}, {'tx': 8, 'success': 1, 'collisions': 7}, {'tx': 10, 'success': 4, 'collisions': 6}, {'tx': 11, 'success': 5, 'collisions': 6}, {'tx': 10, 'success': 2, 'collisions': 8}, {'tx': 9, 'success': 3, 'collisions': 6}, {'tx': 8, 'success': 3, 'collisions': 5}, {'tx': 3, 'success': 0, 'collisions': 3}, {'tx': 9, 'success': 3, 'collisions': 6}, {'tx': 8, 'success': 2, 'collisions': 6}, {'tx': 11, 'success': 3, 'collisions': 8}, {'tx': 4, 'success': 0, 'collisions': 4}, {'tx': 12, 'success': 5, 'collisions': 7}, {'tx': 6, 'success': 2, 'collisions': 4}, {'tx': 7, 'success': 1, 'collisions': 6}, {'tx': 3, 'success': 0, 'collisions': 3}, {'tx': 5, 'success': 0, 'collisions': 5}, {'tx': 10, 'success': 5, 'collisions': 5}, {'tx': 7, 'success': 1, 'collisions': 6}, {'tx': 4, 'success': 0, 'collisions': 4}, {'tx': 3, 'success': 0, 'collisions': 3}, {'tx': 6, 'success': 1, 'collisions': 5}, {'tx': 4, 'success': 0, 'collisions': 4}, {'tx': 10, 'success': 3, 'collisions': 7}, {'tx': 6, 'success': 1, 'collisions': 5}, {'tx': 11, 'success': 4, 'collisions': 7}, {'tx': 6, 'success': 2, 'collisions': 4}]"
190,30,91,200,56,144,0.72,0.28,0.5096,"[{'tx': 6, 'success': 1, 'collisions': 5}, {'tx': 10, 'success': 4, 'collisions': 6}, {'tx': 4, 'success': 0, 'collisions': 4}, {'tx': 4, 'success': 0, 'collisions': 4}, {'tx': 4, 'success': 0, 'collisions': 4}, {'tx': 4, 'success': 0, 'collisions': 4}, {'tx': 13, 'success': 7, 'collisions': 6}, {'tx': 8, 'success': 2, 'collisions': 6}, {'tx': 11, 'success': 5, 'collisions': 6}, {'tx': 10, 'success': 4, 'collisions': 6}, {'tx': 3, 'success': 0, 'collisions': 3}, {'tx': 3, 'success': 0, 'collisions': 3}, {'tx': 6, 'success': 1, 'collisions': 5}, {'tx': 10, 'success': 5, 'collisions': 5}, {'tx': 8, 'success': 2, 'collisions': 6}, {'tx': 12, 'success': 7, 'collisions': 5}, {'tx': 3, 'success': 0, 'collisions': 3}, {'tx': 8, 'success': 3, 'collisions': 5}, {'tx': 8, 'success': 2, 'collisions': 6}, {'tx': 6, 'success': 1, 'collisions': 5}, {'tx': 3, 'success': 0, 'collisions': 3}, {'tx': 7, 'success': 2, 'collisions': 5}, {'tx': 7, 'success': 2, 'collisions': 5}, {'tx': 5, 'success': 0, 'collisions': 5}, {'tx': 12, 'success': 6, 'collisions': 6}, {'tx': 5, 'success': 0, 'collisions': 5}, {'tx': 7, 'success': 1, 'collisions': 6}, {'tx': 4, 'success': 0, 'collisions': 4}, {'tx': 5, 'success': 1, 'collisions': 4}, {'tx': 4, 'success': 0, 'collisions': 4}]"
191,30,92,196,52,144,0.7346938775510204,0.2653061224489796,0.4784,"[{'tx': 6, 'success': 1, 'collisions': 5}, {'tx': 12, 'success': 5, 'collisions': 7}, {'tx': 3, 'success': 0, 'collisions': 3}, {'tx': 9, 'success': 3, 'collisions': 6}, {'tx': 4, 'success': 1, 'collisions': 3}, {'tx': 13, 'success': 7, 'collisions': 6}, {'tx': 5, 'success': 0, 'collisions': 5}, {'tx': 4, 'success': 0, 'collisions': 4}, {'tx': 9, 'success': 3, 'collisions': 6}, {'tx': 4, 'success': 0, 'collisions': 4}, {'tx': 3, 'success': 0, 'collisions': 3}, {'tx': 9, 'success': 3, 'collisions': 6}, {'tx': 4, 'success': 0, 'collisions': 4}, {'tx': 8, 'success': 2, 'collisions': 6}, {'tx': 5, 'success': 2, 'collisions': 3}, {'tx': 12, 'success': 5, 'collisions': 7}, {'tx': 6, 'success': 1, 'collisions': 5}, {'tx': 5, 'success': 0, 'collisions': 5}, {'tx': 3, 'success': 0, 'collisions': 3}, {'tx': 5, 'success': 0, 'collisions': 5}, {'tx': 4, 'success': 0, 'collisions': 4}, {'tx': 4, 'success': 0, 'collisions': 4}, {'tx': 5, 'success': 0, 'collisions': 5}, {'tx': 9, 'success': 2, 'collisions': 7}, {'tx': 11, 'success': 6, 'collisions': 5}, {'tx': 15, 'success': 8, 'collisions': 7}, {'tx': 4, 'success': 0, 'collisions': 4}, {'tx': 4, 'success': 1, 'collisions': 3}, {'tx': 4, 'success': 0, 'collisions': 4}, {'tx': 7, 'success': 2, 'collisions': 5}]"
192,30,93,189,52,137,0.7248677248677249,0.2751322751322751,0.4836,"[{'tx': 4, 'success': 0, 'collisions': 4}, {'tx': 4, 'success': 0, 'collisions': 4}, {'tx': 9, 'success': 2, 'collisions': 7}, {'tx': 15, 'success': 9, 'collisions': 6}, {'tx': 9, 'success': 5, 'collisions': 4}, {'tx': 11, 'success': 4, 'collisions': 7}, {'tx': 3, 'success': 0, 'collisions': 3}, {'tx': 8, 'success': 2, 'collisions': 6}, {'tx': 3, 'success': 0, 'collisions': 3}, {'tx': 7, 'success': 1, 'collisions': 6}, {'tx': 12, 'success': 5, 'collisions': 7}, {'tx': 10, 'success': 5, 'collisions': 5}, {'tx': 3, 'success': 0, 'collisions': 3}, {'tx': 4, 'success': 0, 'collisions': 4}, {'tx': 5, 'success': 0, 'collisions': 5}, {'tx': 3, 'success': 0, 'collisions': 3}, {'tx': 4, 'success': 1, 'collisions': 3}, {'tx': 13, 'success': 7, 'collisions': 6}, {'tx': 11, 'success': 5, 'collisions': 6}, {'tx': 4, 'success': 0, 'collisions': 4}, {'tx': 3, 'success': 0, 'collisions': 3}, {'tx': 6, 'success': 1, 'collisions': 5}, {'tx': 3, 'success': 0, 'collisions': 3}, {'tx': 6, 'success': 1, 'collisions': 5}, {'tx': 5, 'success': 0, 'collisions': 5}, {'tx': 7, 'success': 2, 'collisions': 5}, {'tx': 4, 'success': 0, 'collisions': 4}, {'tx': 4, 'success': 1, 'collisions': 3}, {'tx': 6, 'success': 1, 'collisions': 5}, {'tx': 3, 'success': 0, 'collisions': 3}]"
193,30,94,191,51,140,0.7329842931937173,0.2670157068062827,0.4794,"[{'tx': 9, 'success': 4, 'collisions': 5}, {'tx': 7, 'success': 1, 'collisions': 6}, {'tx': 11, 'success': 5, 'collisions': 6}, {'tx': 7, 'success': 1, 'collisions': 6}, {'tx': 6, 'success': 1, 'collisions': 5}, {'tx': 7, 'success': 3, 'collisions': 4}, {'tx': 7, 'success': 3, 'collisions': 4}, {'tx': 7, 'success': 2, 'collisions': 5}, {'tx': 6, 'success': 1, 'collisions': 5}, {'tx': 4, 'success': 0, 'collisions': 4}, {'tx': 4, 'success': 1, 'collisions': 3}, {'tx': 5, 'success': 1, 'collisions': 4}, {'tx': 4, 'success': 1, 'collisions': 3}, {'tx': 4, 'success': 0, 'collisions': 4}, {'tx': 5, 'success': 0, 'collisions': 5}, {'tx': 6, 'success': 0, 'collisions': 6}, {'tx': 7, 'success': 1, 'collisions': 6}, {'tx': 3, 'success': 0, 'collisions': 3}, {'tx': 5, 'success': 1, 'collisions': 4}, {'tx': 7, 'success': 2, 'collisions': 5}, {'tx': 7, 'success': 2, 'collisions': 5}, {'tx': 3, 'success': 0, 'collisions': 3}, {'tx': 7, 'success': 2, 'collisions': 5}, {'tx': 5, 'success': 0, 'collisions': 5}, {'tx': 7, 'success': 2, 'collisions': 5}, {'tx': 8, 'success': 2, 'collisions': 6}, {'tx': 6, 'success': 1, 'collisions': 5}, {'tx': 10, 'success': 6, 'collisions': 4}, {'tx': 6, 'success': 1, 'collisions': 5}, {'tx': 11, 'success': 7, 'collisions': 4}]"
194,30,95,197,49,148,0.751269035532995,0.24873096446700507,0.4655,"[{'tx': 7, 'success': 3, 'collisions': 4}, {'tx': 4, 'success': 0, 'collisions': 4}, {'tx': 9, 'success': 2, 'collisions': 7}, {'tx': 4, 'success': 0, 'collisions': 4}, {'tx': 7, 'success': 2, 'collisions': 5}, {'tx': 4, 'success': 0, 'collisions': 4}, {'tx': 8, 'success': 2, 'collisions': 6}, {'tx': 13, 'success': 7, 'collisions': 6}, {'tx': 4, 'success': 0, 'collisions': 4}, {'tx': 3, 'success': 0, 'collisions': 3}, {'tx': 3, 'success': 0, 'collisions': 3}, {'tx': 5, 'success': 1, 'collisions': 4}, {'tx': 10, 'success': 3, 'collisions': 7}, {'tx': 3, 'success': 0, 'collisions': 3}, {'tx': 6, 'success': 1, 'collisions': 5}, {'tx': 7, 'success': 1, 'collisions': 6}, {'tx': 12, 'success': 5, 'collisions': 7}, {'tx': 9, 'success': 4, 'collisions': 5}, {'tx': 4, 'success': 0, 'collisions': 4}, {'tx': 9, 'success': 3, 'collisions': 6}, {'tx': 10, 'success': 3, 'collisions': 7}, {'tx': 10, 'success': 3, 'collisions': 7}, {'tx': 5, 'success': 0, 'collisions': 5}, {'tx': 11, 'success': 6, 'collisions': 5}, {'tx': 3, 'success': 0, 'collisions': 3}, {'tx': 8, 'success': 2, 'collisions': 6}, {'tx': 4, 'success': 0, 'collisions': 4}, {'tx': 7, 'success': 1, 'collisions': 6}, {'tx': 4, 'success': 0, 'collisions': 4}, {'tx': 4, 'success': 0, 'collisions': 4}]"
195,30,96,190,48,142,0.7473684210526316,0.25263157894736843,0.4608,"[{'tx': 4, 'success': 0, 'collisions': 4}, {'tx': 3, 'success': 0, 'collisions': 3}, {'tx': 8, 'success': 4, 'collisions': 4}, {'tx': 7, 'success': 1, 'collisions': 6}, {'tx': 8, 'success': 2, 'collisions': 6}, {'tx': 5, 'success': 1, 'collisions': 4}, {'tx': 5, 'success': 1, 'collisions': 4}, {'tx': 5, 'success': 1, 'collisions': 4}, {'tx': 7, 'success': 2, 'collisions': 5}, {'tx': 3, 'success': 0, 'collisions': 3}, {'tx': 6, 'success': 1, 'collisions': 5}, {'tx': 7, 'success': 3, 'collisions': 4}, {'tx': 8, 'success': 2, 'collisions': 6}, {'tx': 6, 'success': 1, 'collisions': 5}, {'tx': 3, 'success': 0, 'collisions': 3}, {'tx': 3, 'success': 0, 'collisions': 3}, {'tx': 10, 'success': 4, 'collisions': 6}, {'tx': 7, 'success': 2, 'collisions': 5}, {'tx': 12, 'success': 5, 'collisions': 7}, {'tx': 6, 'success': 1, 'collisions': 5}, {'tx': 8, 'success': 2, 'collisions': 6}, {'tx': 8, 'success': 3, 'collisions': 5}, {'tx': 8, 'success': 4, 'collisions': 4}, {'tx': 7, 'success': 2, 'collisions': 5}, {'tx': 6, 'success': 1, 'collisions': 5}, {'tx': 5, 'success': 1, 'collisions': 4}, {'tx': 8, 'success': 1, 'collisions': 7}, {'tx': 7, 'success': 2, 'collisions': 5}, {'tx': 6, 'success': 1, 'collisions': 5}, {'tx': 4, 'success': 0, 'collisions': 4}]"
196,30,97,185,52,133,0.7189189189189189,0.2810810810810811,0.5044,"[{'tx': 3, 'success': 0, 'collisions': 3}, {'tx': 4, 'success': 0, 'collisions': 4}, {'tx': 6, 'success': 1, 'collisions': 5}, {'tx': 11, 'success': 5, 'collisions': 6}, {'tx': 5, 'success': 2, 'collisions': 3}, {'tx': 4, 'success': 0, 'collisions': 4}, {'tx': 3, 'success': 0, 'collisions': 3}, {'tx': 12, 'success': 4, 'collisions': 8}, {'tx': 7, 'success': 3, 'collisions': 4}, {'tx': 3, 'success': 0, 'collisions': 3}, {'tx': 9, 'success': 4, 'collisions': 5}, {'tx': 6, 'success': 1, 'collisions': 5}, {'tx': 4, 'success': 0, 'collisions': 4}, {'tx': 3, 'success': 0, 'collisions': 3}, {'tx': 8, 'success': 3, 'collisions': 5}, {'tx': 8, 'success': 2, 'collisions': 6}, {'tx': 3, 'success': 0, 'collisions': 3}, {'tx': 5, 'success': 1, 'collisions': 4}, {'tx': 5, 'success': 1, 'collisions': 4}, {'tx': 4, 'success': 0, 'collisions': 4}, {'tx': 8, 'success': 3, 'collisions': 5}, {'tx': 4, 'success': 0, 'collisions': 4}, {'tx': 9, 'success': 3, 'collisions': 6}, {'tx': 4, 'success': 0, 'collisions': 4}, {'tx': 7, 'success': 2, 'collisions': 5}, {'tx': 14, 'success': 7, 'collisions': 7}, {'tx': 11, 'success': 6, 'collisions': 5}, {'tx': 5, 'success': 1, 'collisions': 4}, {'tx': 6, 'success': 3, 'collisions': 3}, {'tx': 4, 'success': 0, 'collisions': 4}]"
197,30,98,188,45,143,0.7606382978723404,0.2393617021276596,0.441,"[{'tx': 8, 'success': 2, 'collisions': 6}, {'tx': 9, 'success': 3, 'collisions': 6}, {'tx': 12, 'success': 7, 'collisions': 5}, {'tx': 4, 'success': 1, 'collisions': 3}, {'tx': 8, 'success': 1, 'collisions': 7}, {'tx': 3, 'success': 0, 'collisions': 3}, {'tx': 3, 'success': 0, 'collisions': 3}, {'tx': 9, 'success': 3, 'collisions': 6}, {'tx': 4, 'success': 0, 'collisions': 4}, {'tx': 4, 'success': 0, 'collisions': 4}, {'tx': 4, 'success': 0, 'collisions': 4}, {'tx': 6, 'success': 1, 'collisions': 5}, {'tx': 4, 'success': 0, 'collisions': 4}, {'tx': 6, 'success': 1, 'collisions': 5}, {'tx': 6, 'success': 1, 'collisions': 5}, {'tx': 9, 'success': 2, 'collisions': 7}, {'tx': 7, 'success': 3, 'collisions': 4}, {'tx': 3, 'success': 0, 'collisions': 3}, {'tx': 4, 'success': 0, 'collisions': 4}, {'tx': 10, 'success': 4, 'collisions': 6}, {'tx': 7, 'success': 2, 'collisions': 5}, {'tx': 3, 'success': 0, 'collisions': 3}, {'tx': 4, 'success': 0, 'collisions': 4}, {'tx': 9, 'success': 3, 'collisions': 6}, {'tx': 4, 'success': 0, 'collisions': 4}, {'tx': 11, 'success': 5, 'collisions': 6}, {'tx': 4, 'success': 0, 'collisions': 4}, {'tx': 9, 'success': 3, 'collisions': 6}, {'tx': 6, 'success': 1, 'collisions': 5}, {'tx': 8, 'success': 2, 'collisions': 6}]"
198,30,99,179,50,129,0.7206703910614525,0.27932960893854747,0.495,"[{'tx': 4, 'success': 0, 'collisions': 4}, {'tx': 4, 'success': 0, 'collisions': 4}, {'tx': 7, 'success': 2, 'collisions': 5}, {'tx': 3, 'success': 0, 'collisions': 3}, {'tx': 3, 'success': 0, 'collisions': 3}, {'tx': 6, 'success': 1, 'collisions': 5}, {'tx': 11, 'success': 6, 'collisions': 5}, {'tx': 4, 'success': 0, 'collisions': 4}, {'tx': 7, 'success': 2, 'collisions': 5}, {'tx': 5, 'success': 1, 'collisions': 4}, {'tx': 3, 'success': 0, 'collisions': 3}, {'tx': 3, 'success': 0, 'collisions': 3}, {'tx': 7, 'success': 2, 'collisions': 5}, {'tx': 5, 'success': 0, 'collisions': 5}, {'tx': 9, 'success': 5, 'collisions': 4}, {'tx': 9, 'success': 4, 'collisions': 5}, {'tx': 6, 'success': 1, 'collisions': 5}, {'tx': 6, 'success': 1, 'collisions': 5}, {'tx': 7, 'success': 2, 'collisions': 5}, {'tx': 4, 'success': 0, 'collisions': 4}, {'tx': 3, 'success': 0, 'collisions': 3}, {'tx': 12, 'success': 9, 'collisions': 3}, {'tx': 9, 'success': 5, 'collisions': 4}, {'tx': 4, 'success': 0, 'collisions': 4}, {'tx': 8, 'success': 2, 'collisions': 6}, {'tx': 3, 'success': 0, 'collisions': 3}, {'tx': 6, 'success': 1, 'collisions': 5}, {'tx': 9, 'success': 4, 'collisions': 5}, {'tx': 8, 'success': 2, 'collisions': 6}, {'tx': 4, 'success': 0, 'collisions': 4}]"
199,30,100,178,51,127,0.7134831460674157,0.28651685393258425,0.51,"[{'tx': 9, 'success': 3, 'collisions': 6}, {'tx': 4, 'success': 0, 'collisions': 4}, {'tx': 4, 'success': 0, 'collisions': 4}, {'tx': 7, 'success': 2, 'collisions': 5}, {'tx': 4, 'success': 1, 'collisions': 3}, {'tx': 8, 'success': 2, 'collisions': 6}, {'tx': 4, 'success': 0, 'collisions': 4}, {'tx': 3, 'success': 0, 'collisions': 3}, {'tx': 4, 'success': 0, 'collisions': 4}, {'tx': 5, 'success': 1, 'collisions': 4}, {'tx': 8, 'success': 3, 'collisions': 5}, {'tx': 4, 'success': 0, 'collisions': 4}, {'tx': 7, 'success': 2, 'collisions': 5}, {'tx': 4, 'success': 0, 'collisions': 4}, {'tx': 10, 'success': 5, 'collisions': 5}, {'tx': 6, 'success': 1, 'collisions': 5}, {'tx': 11, 'success': 5, 'collisions': 6}, {'tx': 3, 'success': 0, 'collisions': 3}, {'tx': 4, 'success': 1, 'collisions': 3}, {'tx': 4, 'success': 0, 'collisions': 4}, {'tx': 7, 'success': 3, 'collisions': 4}, {'tx': 3, 'success': 0, 'collisions': 3}, {'tx': 9, 'success': 5, 'collisions': 4}, {'tx': 10, 'success': 4, 'collisions': 6}, {'tx': 5, 'success': 1, 'collisions': 4}, {'tx': 3, 'success': 0, 'collisions': 3}, {'tx': 11, 'success': 7, 'collisions': 4}, {'tx': 3, 'success': 0, 'collisions': 3}, {'tx': 4, 'success': 0, 'collisions': 4}, {'tx': 10, 'success': 5, 'collisions': 5}]"
200,40,1,8331,3639,4692,0.5631976953546993,0.4368023046453007,0.3639,"[{'tx': 218, 'success': 88, 'collisions': 130}, {'tx': 167, 'success': 77, 'collisions': 90}, {'tx': 373, 'success': 188, 'collisions': 185}, {'tx': 124, 'success': 51, 'collisions': 73}, {'tx': 148, 'success': 57, 'collisions': 91}, {'tx': 197, 'success': 77, 'collisions': 120}, {'tx': 213, 'success': 96, 'collisions': 117}, {'tx': 374, 'success': 182, 'collisions': 192}, {'tx': 231, 'success': 90, 'collisions': 141}, {'tx': 128, 'success': 54, 'collisions': 74}, {'tx': 111, 'success': 48, 'collisions': 63}, {'tx': 325, 'success': 153, 'collisions': 172}, {'tx': 204, 'success': 85, 'collisions': 119}, {'tx': 187, 'success': 78, 'collisions': 109}, {'tx': 176, 'success': 70, 'collisions': 106}, {'tx': 173, 'success': 72, 'collisions': 101}, {'tx': 196, 'success': 84, 'collisions': 112}, {'tx': 142, 'success': 54, 'collisions': 88}, {'tx': 296, 'success': 144, 'collisions': 152}, {'tx': 56, 'success': 14, 'collisions': 42}, {'tx': 118, 'success': 47, 'collisions': 71}, {'tx': 168, 'success': 76, 'collisions': 92}, {'tx': 155, 'success': 58, 'collisions': 97}, {'tx': 248, 'success': 110, 'collisions': 138}, {'tx': 196, 'success': 87, 'collisions': 109}, {'tx': 200, 'success': 89, 'collisions': 111}, {'tx': 98, 'success': 30, 'collisions': 68}, {'tx': 250, 'success': 105, 'collisions': 145}, {'tx': 233, 'success': 99, 'collisions': 134}, {'tx': 124, 'success': 45, 'collisions': 79}, {'tx': 241, 'success': 110, 'collisions': 131}, {'tx': 182, 'success': 83, 'collisions': 99}, {'tx': 403, 'success': 190, 'collisions': 213}, {'tx': 250, 'success': 113, 'collisions': 137}, {'tx': 236, 'success': 100, 'collisions': 136}, {'tx': 241, 'success': 117, 'collisions': 124}, {'tx': 250, 'success': 103, 'collisions': 147}, {'tx': 180, 'success': 75, 'collisions': 105}, {'tx': 139, 'success': 64, 'collisions': 75}, {'tx': 380, 'success': 176, 'collisions': 204}]"
201,40,2,5368,2317,3051,0.5683681073025335,0.4316318926974665,0.4634,"[{'tx': 142, 'success': 61, 'collisions': 81}, {'tx': 177, 'success': 83, 'collisions': 94}, {'tx': 51, 'success': 19, 'collisions': 32}, {'tx': 95, 'success': 29, 'collisions': 66}, {'tx': 225, 'success': 104, 'collisions': 121}, {'tx': 40, 'success': 15, 'collisions': 25}, {'tx': 66, 'success': 25, 'collisions': 41}, {'tx': 123, 'success': 48, 'collisions': 75}, {'tx': 43, 'success': 14, 'collisions': 29}, {'tx': 147, 'success': 58, 'collisions': 89}, {'tx': 201, 'success': 99, 'collisions': 102}, {'tx': 53, 'success': 17, 'collisions': 36}, {'tx': 159, 'success': 65, 'collisions': 94}, {'tx': 129, 'success': 45, 'collisions': 84}, {'tx': 174, 'success': 74, 'collisions': 100}, {'tx': 42, 'success': 14, 'collisions': 28}, {'tx': 88, 'success': 32, 'collisions': 56}, {'tx': 91, 'success': 36, 'collisions': 55}, {'tx': 136, 'success': 59, 'collisions': 77}, {'tx': 203, 'success': 82, 'collisions': 121}, {'tx': 150, 'success': 66, 'collisions': 84}, {'tx': 80, 'success': 32, 'collisions': 48}, {'tx': 103, 'success': 46, 'collisions': 57}, {'tx': 273, 'success': 135, 'collisions': 138}, {'tx': 149, 'success': 66, 'collisions': 83}, {'tx': 217, 'success': 104, 'collisions': 113}, {'tx': 175, 'success': 83, 'collisions': 92}, {'tx': 90, 'success': 35, 'collisions': 55}, {'tx': 108, 'success': 48, 'collisions': 60}, {'tx': 249, 'success': 119, 'collisions': 130}, {'tx': 204, 'success': 103, 'collisions': 101}, {'tx': 132, 'success': 51, 'collisions': 81}, {'tx': 278, 'success': 135, 'collisions': 143}, {'tx': 68, 'success': 24, 'collisions': 44}, {'tx': 86, 'success': 29, 'collisions': 57}, {'tx': 168, 'success': 73, 'collisions': 95}, {'tx': 53, 'success': 21, 'collisions': 32}, {'tx': 141, 'success': 60, 'collisions': 81}, {'tx': 185, 'success': 84, 'collisions': 101}, {'tx': 74, 'success': 24, 'collisions': 50}]"
202,40,3,3990,1710,2280,0.5714285714285714,0.42857142857142855,0.513,"[{'tx': 39, 'success': 13, 'collisions': 26}, {'tx': 68, 'success': 31, 'collisions': 37}, {'tx': 63, 'success': 22, 'collisions': 41}, {'tx': 9, 'success': 0, 'collisions': 9}, {'tx': 53, 'success': 17, 'collisions': 36}, {'tx': 78, 'success': 37, 'collisions': 41}, {'tx': 27, 'success': 8, 'collisions': 19}, {'tx': 66, 'success': 27, 'collisions': 39}, {'tx': 129, 'success': 54, 'collisions': 75}, {'tx': 69, 'success': 24, 'collisions': 45}, {'tx': 28, 'success': 7, 'collisions': 21}, {'tx': 102, 'success': 44, 'collisions': 58}, {'tx': 168, 'success': 73, 'collisions': 95}, {'tx': 99, 'success': 40, 'collisions': 59}, {'tx': 88, 'success': 37, 'collisions': 51}, {'tx': 105, 'success': 39, 'collisions': 66}, {'tx': 30, 'success': 10, 'collisions': 20}, {'tx': 140, 'success': 62, 'collisions': 78}, {'tx': 57, 'success': 16, 'collisions': 41}, {'tx': 183, 'success': 83, 'collisions': 100}, {'tx': 105, 'success': 36, 'collisions': 69}, {'tx': 242, 'success': 126, 'collisions': 116}, {'tx': 70, 'success': 21, 'collisions': 49}, {'tx': 12, 'success': 1, 'collisions': 11}, {'tx': 124, 'success': 52, 'collisions': 72}, {'tx': 152, 'success': 69, 'collisions': 83}, {'tx': 100, 'success': 46, 'collisions': 54}, {'tx': 58, 'success': 21, 'collisions': 37}, {'tx': 175, 'success': 90, 'collisions': 85}, {'tx': 120, 'success': 57, 'collisions': 63}, {'tx': 150, 'success': 75, 'collisions': 75}, {'tx': 176, 'success': 93, 'collisions': 83}, {'tx': 120, 'success': 49, 'collisions': 71}, {'tx': 96, 'success': 39, 'collisions': 57}, {'tx': 76, 'success': 29, 'collisions': 47}, {'tx': 132, 'success': 57, 'collisions': 75}, {'tx': 132, 'success': 61, 'collisions': 71}, {'tx': 147, 'success': 64, 'collisions': 83}, {'tx': 153, 'success': 61, 'collisions': 92}, {'tx': 49, 'success': 19, 'collisions': 30}]"
203,40,4,3115,1353,1762,0.5656500802568218,0.43434991974317816,0.5412,"[{'tx': 32, 'success': 10, 'collisions': 22}, {'tx': 112, 'success': 51, 'collisions': 61}, {'tx': 38, 'success': 12, 'collisions': 26}, {'tx': 84, 'success': 34, 'collisions': 50}, {'tx': 51, 'success': 19, 'collisions': 32}, {'tx': 38, 'success': 13, 'collisions': 25}, {'tx': 102, 'success': 46, 'collisions': 56}, {'tx': 148, 'success': 72, 'collisions': 76}, {'tx': 67, 'success': 27, 'collisions': 40}, {'tx': 47, 'success': 16, 'collisions': 31}, {'tx': 127, 'success': 57, 'collisions': 70}, {'tx': 82, 'success': 37, 'collisions': 45}, {'tx': 78, 'success': 29, 'collisions': 49}, {'tx': 34, 'success': 8, 'collisions': 26}, {'tx': 145, 'success': 73, 'collisions': 72}, {'tx': 92, 'success': 47, 'collisions': 45}, {'tx': 31, 'success': 10, 'collisions': 21}, {'tx': 56, 'success': 21, 'collisions': 35}, {'tx': 126, 'success': 65, 'collisions': 61}, {'tx': 131, 'success': 69, 'collisions': 62}, {'tx': 51, 'success': 20, 'collisions': 31}, {'tx': 104, 'success': 50, 'collisions': 54}, {'tx': 64, 'success': 26, 'collisions': 38}, {'tx': 38, 'success': 15, 'collisions': 23}, {'tx': 29, 'success': 8, 'collisions': 21}, {'tx': 54, 'success': 22, 'collisions': 32}, {'tx': 39, 'success': 15, 'collisions': 24}, {'tx': 76, 'success': 30, 'collisions': 46}, {'tx': 80, 'success': 43, 'collisions': 37}, {'tx': 77, 'success': 33, 'collisions': 44}, {'tx': 95, 'success': 43, 'collisions': 52}, {'tx': 99, 'success': 39, 'collisions': 60}, {'tx': 61, 'success': 26, 'collisions': 35}, {'tx': 28, 'success': 8, 'collisions': 20}, {'tx': 140, 'success': 66, 'collisions': 74}, {'tx': 71, 'success': 28, 'collisions': 43}, {'tx': 97, 'success': 37, 'collisions': 60}, {'tx': 61, 'success': 22, 'collisions': 39}, {'tx': 61, 'success': 24, 'collisions': 37}, {'tx': 169, 'success': 82, 'collisions': 87}]"
204,40,5,2592,1114,1478,0.5702160493827161,0.42978395061728397,0.557,"[{'tx': 11, 'success': 2, 'collisions': 9}, {'tx': 51, 'success': 19, 'collisions': 32}, {'tx': 33, 'success': 12, 'collisions': 21}, {'tx': 28, 'success': 11, 'collisions': 17}, {'tx': 8, 'success': 0, 'collisions': 8}, {'tx': 90, 'success': 43, 'collisions': 47}, {'tx': 106, 'success': 53, 'collisions': 53}, {'tx': 98, 'success': 41, 'collisions': 57}, {'tx': 130, 'success': 71, 'collisions': 59}, {'tx': 46, 'success': 17, 'collisions': 29}, {'tx': 59, 'success': 26, 'collisions': 33}, {'tx': 112, 'success': 47, 'collisions': 65}, {'tx': 115, 'success': 60, 'collisions': 55}, {'tx': 42, 'success': 15, 'collisions': 27}, {'tx': 78, 'success': 29, 'collisions': 49}, {'tx': 51, 'success': 21, 'collisions': 30}, {'tx': 88, 'success': 34, 'collisions': 54}, {'tx': 75, 'success': 35, 'collisions': 40}, {'tx': 61, 'success': 23, 'collisions': 38}, {'tx': 101, 'success': 46, 'collisions': 55}, {'tx': 101, 'success': 45, 'collisions': 56}, {'tx': 128, 'success': 70, 'collisions': 58}, {'tx': 50, 'success': 20, 'collisions': 30}, {'tx': 12, 'success': 1, 'collisions': 11}, {'tx': 18, 'success': 5, 'collisions': 13}, {'tx': 78, 'success': 33, 'collisions': 45}, {'tx': 40, 'success': 17, 'collisions': 23}, {'tx': 79, 'success': 39, 'collisions': 40}, {'tx': 81, 'success': 38, 'collisions': 43}, {'tx': 10, 'success': 0, 'collisions': 10}, {'tx': 14, 'success': 3, 'collisions': 11}, {'tx': 97, 'success': 41, 'collisions': 56}, {'tx': 108, 'success': 46, 'collisions': 62}, {'tx': 67, 'success': 31, 'collisions': 36}, {'tx': 15, 'success': 3, 'collisions': 12}, {'tx': 31, 'success': 7, 'collisions': 24}, {'tx': 123, 'success': 54, 'collisions': 69}, {'tx': 34, 'success': 12, 'collisions': 22}, {'tx': 77, 'success': 31, 'collisions': 46}, {'tx': 46, 'success': 13, 'collisions': 33}]"
205,40,6,2281,920,1361,0.5966681280140289,0.4033318719859711,0.552,"[{'tx': 60, 'success': 25, 'collisions': 35}, {'tx': 26, 'success': 5, 'collisions': 21}, {'tx': 29, 'success': 13, 'collisions': 16}, {'tx': 13, 'success': 1, 'collisions': 12}, {'tx': 105, 'success': 53, 'collisions': 52}, {'tx': 100, 'success': 40, 'collisions': 60}, {'tx': 58, 'success': 23, 'collisions': 35}, {'tx': 13, 'success': 2, 'collisions': 11}, {'tx': 20, 'success': 4, 'collisions': 16}, {'tx': 46, 'success': 14, 'collisions': 32}, {'tx': 68, 'success': 22, 'collisions': 46}, {'tx': 16, 'success': 3, 'collisions': 13}, {'tx': 49, 'success': 22, 'collisions': 27}, {'tx': 17, 'success': 3, 'collisions': 14}, {'tx': 84, 'success': 35, 'collisions': 49}, {'tx': 89, 'success': 37, 'collisions': 52}, {'tx': 57, 'success': 26, 'collisions': 31}, {'tx': 79, 'success': 41, 'collisions': 38}, {'tx': 48, 'success': 16, 'collisions': 32}, {'tx': 66, 'success': 22, 'collisions': 44}, {'tx': 70, 'success': 29, 'collisions': 41}, {'tx': 60, 'success': 31, 'collisions': 29}, {'tx': 84, 'success': 31, 'collisions': 53}, {'tx': 60, 'success': 30, 'collisions': 30}, {'tx': 32, 'success': 13, 'collisions': 19}, {'tx': 50, 'success': 22, 'collisions': 28}, {'tx': 59, 'success': 18, 'collisions': 41}, {'tx': 69, 'success': 24, 'collisions': 45}, {'tx': 48, 'success': 12, 'collisions': 36}, {'tx': 71, 'success': 30, 'collisions': 41}, {'tx': 78, 'success': 33, 'collisions': 45}, {'tx': 56, 'success': 27, 'collisions': 29}, {'tx': 89, 'success': 41, 'collisions': 48}, {'tx': 14, 'success': 2, 'collisions': 12}, {'tx': 126, 'success': 60, 'collisions': 66}, {'tx': 11, 'success': 2, 'collisions': 9}, {'tx': 32, 'success': 9, 'collisions': 23}, {'tx': 80, 'success': 34, 'collisions': 46}, {'tx': 74, 'success': 34, 'collisions': 40}, {'tx': 75, 'success': 31, 'collisions': 44}]"
206,40,7,1954,815,1139,0.582906857727738,0.417093142272262,0.5705,"[{'tx': 61, 'success': 28, 'collisions': 33}, {'tx': 7, 'success': 0, 'collisions': 7}, {'tx': 21, 'success': 5, 'collisions': 16}, {'tx': 32, 'success': 10, 'collisions': 22}, {'tx': 66, 'success': 28, 'collisions': 38}, {'tx': 41, 'success': 15, 'collisions': 26}, {'tx': 83, 'success': 35, 'collisions': 48}, {'tx': 8, 'success': 0, 'collisions': 8}, {'tx': 70, 'success': 30, 'collisions': 40}, {'tx': 86, 'success': 41, 'collisions': 45}, {'tx': 29, 'success': 8, 'collisions': 21}, {'tx': 34, 'success': 8, 'collisions': 26}, {'tx': 16, 'success': 4, 'collisions': 12}, {'tx': 51, 'success': 21, 'collisions': 30}, {'tx': 50, 'success': 17, 'collisions': 33}, {'tx': 49, 'success': 21, 'collisions': 28}, {'tx': 8, 'success': 0, 'collisions': 8}, {'tx': 61, 'success': 28, 'collisions': 33}, {'tx': 48, 'success': 18, 'collisions': 30}, {'tx': 69, 'success': 32, 'collisions': 37}, {'tx': 98, 'success': 44, 'collisions': 54}, {'tx': 38, 'success': 14, 'collisions': 24}, {'tx': 57, 'success': 23, 'collisions': 34}, {'tx': 62, 'success': 29, 'collisions': 33}, {'tx': 18, 'success': 7, 'collisions': 11}, {'tx': 85, 'success': 40, 'collisions': 45}, {'tx': 28, 'success': 6, 'collisions': 22}, {'tx': 68, 'success': 31, 'collisions': 37}, {'tx': 82, 'success': 40, 'collisions': 42}, {'tx': 7, 'success': 0, 'collisions': 7}, {'tx': 46, 'success': 17, 'collisions': 29}, {'tx': 96, 'success': 48, 'collisions': 48}, {'tx': 83, 'success': 43, 'collisions': 40}, {'tx': 38, 'success': 16, 'collisions': 22}, {'tx': 30, 'success': 12, 'collisions': 18}, {'tx': 60, 'success': 25, 'collisions': 35}, {'tx': 19, 'success': 6, 'collisions': 13}, {'tx': 48, 'success': 25, 'collisions': 23}, {'tx': 57, 'success': 22, 'collisions': 35}, {'tx': 44, 'success': 18, 'collisions': 26}]"
207,40,8,1760,701,1059,0.6017045454545454,0.39829545454545456,0.5608,"[{'tx': 19, 'success': 4, 'collisions': 15}, {'tx': 69, 'success': 33, 'collisions': 36}, {'tx': 74, 'success': 32, 'collisions': 42}, {'tx': 57, 'success': 24, 'collisions': 33}, {'tx': 19, 'success': 6, 'collisions': 13}, {'tx': 62, 'success': 25, 'collisions': 37}, {'tx': 11, 'success': 2, 'collisions': 9}, {'tx': 20, 'success': 3, 'collisions': 17}, {'tx': 15, 'success': 3, 'collisions': 12}, {'tx': 92, 'success': 47, 'collisions': 45}, {'tx': 27, 'success': 10, 'collisions': 17}, {'tx': 52, 'success': 20, 'collisions': 32}, {'tx': 39, 'success': 13, 'collisions': 26}, {'tx': 8, 'success': 0, 'collisions': 8}, {'tx': 70, 'success': 32, 'collisions': 38}, {'tx': 7, 'success': 0, 'collisions': 7}, {'tx': 31, 'success': 8, 'collisions': 23}, {'tx': 39, 'success': 20, 'collisions': 19}, {'tx': 48, 'success': 18, 'collisions': 30}, {'tx': 83, 'success': 36, 'collisions': 47}, {'tx': 63, 'success': 19, 'collisions': 44}, {'tx': 43, 'success': 14, 'collisions': 29}, {'tx': 80, 'success': 36, 'collisions': 44}, {'tx': 8, 'success': 1, 'collisions': 7}, {'tx': 65, 'success': 30, 'collisions': 35}, {'tx': 11, 'success': 1, 'collisions': 10}, {'tx': 123, 'success': 65, 'collisions': 58}, {'tx': 59, 'success': 23, 'collisions': 36}, {'tx': 45, 'success': 20, 'collisions': 25}, {'tx': 9, 'success': 0, 'collisions': 9}, {'tx': 37, 'success': 14, 'collisions': 23}, {'tx': 33, 'success': 11, 'collisions': 22}, {'tx': 47, 'success': 18, 'collisions': 29}, {'tx': 44, 'success': 14, 'collisions': 30}, {'tx': 32, 'success': 13, 'collisions': 19}, {'tx': 63, 'success': 27, 'collisions': 36}, {'tx': 12, 'success': 1, 'collisions': 11}, {'tx': 40, 'success': 14, 'collisions': 26}, {'tx': 68, 'success': 29, 'collisions': 39}, {'tx': 36, 'success': 15, 'collisions': 21}]"
208,40,9,1612,621,991,0.6147642679900744,0.38523573200992556,0.5589,"[{'tx': 11, 'success': 2, 'collisions': 9}, {'tx': 35, 'success': 13, 'collisions': 22}, {'tx': 18, 'success': 4, 'collisions': 14}, {'tx': 25, 'success': 6, 'collisions': 19}, {'tx': 34, 'success': 10, 'collisions': 24}, {'tx': 16, 'success': 4, 'collisions': 12}, {'tx': 90, 'success': 45, 'collisions': 45}, {'tx': 27, 'success': 12, 'collisions': 15}, {'tx': 34, 'success': 9, 'collisions': 25}, {'tx': 75, 'success': 35, 'collisions': 40}, {'tx': 42, 'success': 15, 'collisions': 27}, {'tx': 43, 'success': 15, 'collisions': 28}, {'tx': 51, 'success': 20, 'collisions': 31}, {'tx': 15, 'success': 3, 'collisions': 12}, {'tx': 51, 'success': 24, 'collisions': 27}, {'tx': 72, 'success': 33, 'collisions': 39}, {'tx': 60, 'success': 28, 'collisions': 32}, {'tx': 30, 'success': 11, 'collisions': 19}, {'tx': 40, 'success': 11, 'collisions': 29}, {'tx': 38, 'success': 17, 'collisions': 21}, {'tx': 10, 'success': 3, 'collisions': 7}, {'tx': 12, 'success': 1, 'collisions': 11}, {'tx': 40, 'success': 15, 'collisions': 25}, {'tx': 58, 'success': 26, 'collisions': 32}, {'tx': 31, 'success': 11, 'collisions': 20}, {'tx': 71, 'success': 31, 'collisions': 40}, {'tx': 70, 'success': 31, 'collisions': 39}, {'tx': 30, 'success': 10, 'collisions': 20}, {'tx': 36, 'success': 14, 'collisions': 22}, {'tx': 34, 'success': 17, 'collisions': 17}, {'tx': 14, 'success': 3, 'collisions': 11}, {'tx': 50, 'success': 23, 'collisions': 27}, {'tx': 62, 'success': 21, 'collisions': 41}, {'tx': 59, 'success': 22, 'collisions': 37}, {'tx': 20, 'success': 3, 'collisions': 17}, {'tx': 32, 'success': 8, 'collisions': 24}, {'tx': 60, 'success': 26, 'collisions': 34}, {'tx': 39, 'success': 15, 'collisions': 24}, {'tx': 23, 'success': 5, 'collisions': 18}, {'tx': 54, 'success': 19, 'collisions': 35}]"
209,40,10,1448,565,883,0.6098066298342542,0.39019337016574585,0.565,"[{'tx': 56, 'success': 22, 'collisions': 34}, {'tx': 7, 'success': 0, 'collisions': 7}, {'tx': 76, 'success': 37, 'collisions': 39}, {'tx': 45, 'success': 18, 'collisions': 27}, {'tx': 33, 'success': 12, 'collisions': 21}, {'tx': 68, 'success': 32, 'collisions': 36}, {'tx': 32, 'success': 8, 'collisions': 24}, {'tx': 31, 'success': 11, 'collisions': 20}, {'tx': 20, 'success': 5, 'collisions': 15}, {'tx': 21, 'success': 8, 'collisions': 13}, {'tx': 7, 'success': 0, 'collisions': 7}, {'tx': 70, 'success': 31, 'collisions': 39}, {'tx': 17, 'success': 3, 'collisions': 14}, {'tx': 15, 'success': 4, 'collisions': 11}, {'tx': 7, 'success': 0, 'collisions': 7}, {'tx': 26, 'success': 6, 'collisions': 20}, {'tx': 76, 'success': 34, 'collisions': 42}, {'tx': 30, 'success': 12, 'collisions': 18}, {'tx': 43, 'success': 17, 'collisions': 26}, {'tx': 56, 'success': 26, 'collisions': 30}, {'tx': 47, 'success': 22, 'collisions': 25}, {'tx': 12, 'success': 1, 'collisions': 11}, {'tx': 67, 'success': 31, 'collisions': 36}, {'tx': 12, 'success': 3, 'collisions': 9}, {'tx': 42, 'success': 16, 'collisions': 26}, {'tx': 33, 'success': 15, 'collisions': 18}, {'tx': 38, 'success': 15, 'collisions': 23}, {'tx': 71, 'success': 30, 'collisions': 41}, {'tx': 45, 'success': 17, 'collisions': 28}, {'tx': 7, 'success': 0, 'collisions': 7}, {'tx': 38, 'success': 14, 'collisions': 24}, {'tx': 68, 'success': 30, 'collisions': 38}, {'tx': 28, 'success': 11, 'collisions': 17}, {'tx': 31, 'success': 10, 'collisions': 21}, {'tx': 12, 'success': 2, 'collisions': 10}, {'tx': 22, 'success': 4, 'collisions': 18}, {'tx': 35, 'success': 15, 'collisions': 20}, {'tx': 7, 'success': 0, 'collisions': 7}, {'tx': 25, 'success': 9, 'collisions': 16}, {'tx': 72, 'success': 34, 'collisions': 38}]"
210,40,11,1338,520,818,0.6113602391629297,0.38863976083707025,0.572,"[{'tx': 8, 'success': 1, 'collisions': 7}, {'tx': 54, 'success': 21, 'collisions': 33}, {'tx': 17, 'success': 3, 'collisions': 14}, {'tx': 27, 'success': 9, 'collisions': 18}, {'tx': 65, 'success': 33, 'collisions': 32}, {'tx': 28, 'success': 9, 'collisions': 19}, {'tx': 16, 'success': 3, 'collisions': 13}, {'tx': 14, 'success': 4, 'collisions': 10}, {'tx': 48, 'success': 16, 'collisions': 32}, {'tx': 46, 'success': 22, 'collisions': 24}, {'tx': 7, 'success': 0, 'collisions': 7}, {'tx': 59, 'success': 25, 'collisions': 34}, {'tx': 19, 'success': 4, 'collisions': 15}, {'tx': 73, 'success': 33, 'collisions': 40}, {'tx': 54, 'success': 23, 'collisions': 31}, {'tx': 29, 'success': 10, 'collisions': 19}, {'tx': 6, 'success': 0, 'collisions': 6}, {'tx': 52, 'success': 28, 'collisions': 24}, {'tx': 7, 'success': 0, 'collisions': 7}, {'tx': 7, 'success': 0, 'collisions': 7}, {'tx': 79, 'success': 41, 'collisions': 38}, {'tx': 48, 'success': 19, 'collisions': 29}, {'tx': 44, 'success': 18, 'collisions': 26}, {'tx': 55, 'success': 24, 'collisions': 31}, {'tx': 6, 'success': 0, 'collisions': 6}, {'tx': 26, 'success': 9, 'collisions': 17}, {'tx': 62, 'success': 30, 'collisions': 32}, {'tx': 22, 'success': 7, 'collisions': 15}, {'tx': 47, 'success': 19, 'collisions': 28}, {'tx': 24, 'success': 8, 'collisions': 16}, {'tx': 60, 'success': 27, 'collisions': 33}, {'tx': 16, 'success': 2, 'collisions': 14}, {'tx': 38, 'success': 12, 'collisions': 26}, {'tx': 8, 'success': 1, 'collisions': 7}, {'tx': 21, 'success': 6, 'collisions': 15}, {'tx': 43, 'success': 18, 'collisions': 25}, {'tx': 28, 'success': 8, 'collisions': 20}, {'tx': 9, 'success': 1, 'collisions': 8}, {'tx': 31, 'success': 12, 'collisions': 19}, {'tx': 35, 'success': 14, 'collisions': 21}]"
211,40,12,1224,487,737,0.6021241830065359,0.397875816993464,0.5844,"[{'tx': 7, 'success': 0, 'collisions': 7}, {'tx': 7, 'success': 0, 'collisions': 7}, {'tx': 17, 'success': 6, 'collisions': 11}, {'tx': 49, 'success': 22, 'collisions': 27}, {'tx': 13, 'success': 3, 'collisions': 10}, {'tx': 17, 'success': 3, 'collisions': 14}, {'tx': 41, 'success': 19, 'collisions': 22}, {'tx': 36, 'success': 17, 'collisions': 19}, {'tx': 61, 'success': 30, 'collisions': 31}, {'tx': 6, 'success': 0, 'collisions': 6}, {'tx': 52, 'success': 24, 'collisions': 28}, {'tx': 32, 'success': 13, 'collisions': 19}, {'tx': 43, 'success': 15, 'collisions': 28}, {'tx': 50, 'success': 18, 'collisions': 32}, {'tx': 21, 'success': 8, 'collisions': 13}, {'tx': 46, 'success': 21, 'collisions': 25}, {'tx': 25, 'success': 9, 'collisions': 16}, {'tx': 35, 'success': 12, 'collisions': 23}, {'tx': 32, 'success': 11, 'collisions': 21}, {'tx': 32, 'success': 17, 'collisions': 15}, {'tx': 8, 'success': 0, 'collisions': 8}, {'tx': 32, 'success': 16, 'collisions': 16}, {'tx': 23, 'success': 9, 'collisions': 14}, {'tx': 34, 'success': 15, 'collisions': 19}, {'tx': 47, 'success': 21, 'collisions': 26}, {'tx': 30, 'success': 14, 'collisions': 16}, {'tx': 50, 'success': 22, 'collisions': 28}, {'tx': 8, 'success': 1, 'collisions': 7}, {'tx': 17, 'success': 5, 'collisions': 12}, {'tx': 35, 'success': 13, 'collisions': 22}, {'tx': 8, 'success': 0, 'collisions': 8}, {'tx': 7, 'success': 0, 'collisions': 7}, {'tx': 58, 'success': 23, 'collisions': 35}, {'tx': 8, 'success': 1, 'collisions': 7}, {'tx': 15, 'success': 4, 'collisions': 11}, {'tx': 20, 'success': 5, 'collisions': 15}, {'tx': 44, 'success': 18, 'collisions': 26}, {'tx': 47, 'success': 21, 'collisions': 26}, {'tx': 37, 'success': 14, 'collisions': 23}, {'tx': 74, 'success': 37, 'collisions': 37}]"
212,40,13,1138,446,692,0.6080843585237259,0.39191564147627417,0.5798,"[{'tx': 7, 'success': 0, 'collisions': 7}, {'tx': 36, 'success': 14, 'collisions': 22}, {'tx': 12, 'success': 1, 'collisions': 11}, {'tx': 39, 'success': 18, 'collisions': 21}, {'tx': 7, 'success': 1, 'collisions': 6}, {'tx': 20, 'success': 5, 'collisions': 15}, {'tx': 60, 'success': 31, 'collisions': 29}, {'tx': 15, 'success': 3, 'collisions': 12}, {'tx': 30, 'success': 10, 'collisions': 20}, {'tx': 44, 'success': 18, 'collisions': 26}, {'tx': 11, 'success': 1, 'collisions': 10}, {'tx': 9, 'success': 1, 'collisions': 8}, {'tx': 21, 'success': 6, 'collisions': 15}, {'tx': 19, 'success': 6, 'collisions': 13}, {'tx': 6, 'success': 0, 'collisions': 6}, {'tx': 32, 'success': 14, 'collisions': 18}, {'tx': 50, 'success': 21, 'collisions': 29}, {'tx': 50, 'success': 24, 'collisions': 26}, {'tx': 18, 'success': 6, 'collisions': 12}, {'tx': 13, 'success': 4, 'collisions': 9}, {'tx': 23, 'success': 8, 'collisions': 15}, {'tx': 56, 'success': 31, 'collisions': 25}, {'tx': 57, 'success': 27, 'collisions': 30}, {'tx': 45, 'success': 21, 'collisions': 24}, {'tx': 43, 'success': 17, 'collisions': 26}, {'tx': 18, 'success': 4, 'collisions': 14}, {'tx': 28, 'success': 13, 'collisions': 15}, {'tx': 26, 'success': 10, 'collisions': 16}, {'tx': 38, 'success': 15, 'collisions': 23}, {'tx': 12, 'success': 3, 'collisions': 9}, {'tx': 18, 'success': 6, 'collisions': 12}, {'tx': 49, 'success': 18, 'collisions': 31}, {'tx': 19, 'success': 6, 'collisions': 13}, {'tx': 21, 'success': 6, 'collisions': 15}, {'tx': 38, 'success': 11, 'collisions': 27}, {'tx': 7, 'success': 0, 'collisions': 7}, {'tx': 21, 'success': 9, 'collisions': 12}, {'tx': 64, 'success': 34, 'collisions': 30}, {'tx': 47, 'success': 22, 'collisions': 25}, {'tx': 9, 'success': 1, 'collisions': 8}]"
213,40,14,1079,418,661,0.6126042632066728,0.3873957367933272,0.5852,"[{'tx': 27, 'success': 10, 'collisions': 17}, {'tx': 20, 'success': 7, 'collisions': 13}, {'tx': 8, 'success': 1, 'collisions': 7}, {'tx': 11, 'success': 2, 'collisions': 9}, {'tx': 45, 'success': 18, 'collisions': 27}, {'tx': 33, 'success': 15, 'collisions': 18}, {'tx': 44, 'success': 21, 'collisions': 23}, {'tx': 22, 'success': 6, 'collisions': 16}, {'tx': 23, 'success': 7, 'collisions': 16}, {'tx': 17, 'success': 5, 'collisions': 12}, {'tx': 44, 'success': 17, 'collisions': 27}, {'tx': 6, 'success': 0, 'collisions': 6}, {'tx': 50, 'success': 29, 'collisions': 21}, {'tx': 10, 'success': 1, 'collisions': 9}, {'tx': 29, 'success': 9, 'collisions': 20}, {'tx': 16, 'success': 5, 'collisions': 11}, {'tx': 57, 'success': 28, 'collisions': 29}, {'tx': 46, 'success': 21, 'collisions': 25}, {'tx': 15, 'success': 6, 'collisions': 9}, {'tx': 20, 'success': 6, 'collisions': 14}, {'tx': 20, 'success': 6, 'collisions': 14}, {'tx': 28, 'success': 10, 'collisions': 18}, {'tx': 35, 'success': 14, 'collisions': 21}, {'tx': 15, 'success': 3, 'collisions': 12}, {'tx': 31, 'success': 11, 'collisions': 20}, {'tx': 32, 'success': 14, 'collisions': 18}, {'tx': 32, 'success': 12, 'collisions': 20}, {'tx': 12, 'success': 4, 'collisions': 8}, {'tx': 29, 'success': 9, 'collisions': 20}, {'tx': 31, 'success': 11, 'collisions': 20}, {'tx': 11, 'success': 3, 'collisions': 8}, {'tx': 10, 'success': 1, 'collisions': 9}, {'tx': 21, 'success': 7, 'collisions': 14}, {'tx': 48, 'success': 21, 'collisions': 27}, {'tx': 44, 'success': 19, 'collisions': 25}, {'tx': 7, 'success': 0, 'collisions': 7}, {'tx': 47, 'success': 23, 'collisions': 24}, {'tx': 47, 'success': 24, 'collisions': 23}, {'tx': 6, 'success': 0, 'collisions': 6}, {'tx': 30, 'success': 12, 'collisions': 18}]"
214,40,15,1034,365,669,0.6470019342359767,0.3529980657640232,0.5475,"[{'tx': 28, 'success': 12, 'collisions': 16}, {'tx': 29, 'success': 9, 'collisions': 20}, {'tx': 12, 'success': 2, 'collisions': 10}, {'tx': 20, 'success': 4, 'collisions': 16}, {'tx': 13, 'success': 2, 'collisions': 11}, {'tx': 8, 'success': 1, 'collisions': 7}, {'tx': 46, 'success': 20, 'collisions': 26}, {'tx': 34, 'success': 12, 'collisions': 22}, {'tx': 24, 'success': 10, 'collisions': 14}, {'tx': 38, 'success': 17, 'collisions': 21}, {'tx': 13, 'success': 3, 'collisions': 10}, {'tx': 38, 'success': 17, 'collisions': 21}, {'tx': 11, 'success': 1, 'collisions': 10}, {'tx': 17, 'success': 6, 'collisions': 11}, {'tx': 36, 'success': 13, 'collisions': 23}, {'tx': 9, 'success': 1, 'collisions': 8}, {'tx': 29, 'success': 6, 'collisions': 23}, {'tx': 37, 'success': 16, 'collisions': 21}, {'tx': 18, 'success': 5, 'collisions': 13}, {'tx': 45, 'success': 16, 'collisions': 29}, {'tx': 8, 'success': 0, 'collisions': 8}, {'tx': 18, 'success': 6, 'collisions': 12}, {'tx': 22, 'success': 6, 'collisions': 16}, {'tx': 15, 'success': 4, 'collisions': 11}, {'tx': 42, 'success': 16, 'collisions': 26}, {'tx': 32, 'success': 14, 'collisions': 18}, {'tx': 17, 'success': 4, 'collisions': 13}, {'tx': 18, 'success': 4, 'collisions': 14}, {'tx': 17, 'success': 3, 'collisions': 14}, {'tx': 39, 'success': 16, 'collisions': 23}, {'tx': 55, 'success': 27, 'collisions': 28}, {'tx': 28, 'success': 9, 'collisions': 19}, {'tx': 30, 'success': 10, 'collisions': 20}, {'tx': 51, 'success': 24, 'collisions': 27}, {'tx': 21, 'success': 8, 'collisions': 13}, {'tx': 51, 'success': 25, 'collisions': 26}, {'tx': 11, 'success': 2, 'collisions': 9}, {'tx': 25, 'success': 8, 'collisions': 17}, {'tx': 22, 'success': 6, 'collisions': 16}, {'tx': 7, 'success': 0, 'collisions': 7}]"
215,40,16,955,359,596,0.6240837696335079,0.37591623036649213,0.5744,"[{'tx': 8, 'success': 0, 'collisions': 8}, {'tx': 43, 'success': 17, 'collisions': 26}, {'tx': 36, 'success': 15, 'collisions': 21}, {'tx': 16, 'success': 5, 'collisions': 11}, {'tx': 57, 'success': 27, 'collisions': 30}, {'tx': 18, 'success': 7, 'collisions': 11}, {'tx': 14, 'success': 4, 'collisions': 10}, {'tx': 24, 'success': 10, 'collisions': 14}, {'tx': 21, 'success': 7, 'collisions': 14}, {'tx': 6, 'success': 0, 'collisions': 6}, {'tx': 6, 'success': 0, 'collisions': 6}, {'tx': 31, 'success': 11, 'collisions': 20}, {'tx': 28, 'success': 8, 'collisions': 20}, {'tx': 39, 'success': 22, 'collisions': 17}, {'tx': 6, 'success': 0, 'collisions': 6}, {'tx': 19, 'success': 5, 'collisions': 14}, {'tx': 37, 'success': 15, 'collisions': 22}, {'tx': 39, 'success': 14, 'collisions': 25}, {'tx': 43, 'success': 22, 'collisions': 21}, {'tx': 26, 'success': 8, 'collisions': 18}, {'tx': 13, 'success': 2, 'collisions': 11}, {'tx': 38, 'success': 19, 'collisions': 19}, {'tx': 16, 'success': 5, 'collisions': 11}, {'tx': 18, 'success': 6, 'collisions': 12}, {'tx': 6, 'success': 0, 'collisions': 6}, {'tx': 45, 'success': 24, 'collisions': 21}, {'tx': 42, 'success': 20, 'collisions': 22}, {'tx': 42, 'success': 18, 'collisions': 24}, {'tx': 37, 'success': 18, 'collisions': 19}, {'tx': 13, 'success': 2, 'collisions': 11}, {'tx': 18, 'success': 6, 'collisions': 12}, {'tx': 30, 'success': 9, 'collisions': 21}, {'tx': 6, 'success': 0, 'collisions': 6}, {'tx': 19, 'success': 5, 'collisions': 14}, {'tx': 6, 'success': 0, 'collisions': 6}, {'tx': 9, 'success': 1, 'collisions': 8}, {'tx': 28, 'success': 13, 'collisions': 15}, {'tx': 25, 'success': 8, 'collisions': 17}, {'tx': 21, 'success': 6, 'collisions': 15}, {'tx': 6, 'success': 0, 'collisions': 6}]"
216,40,17,907,332,575,0.6339581036383682,0.36604189636163176,0.5644,"[{'tx': 7, 'success': 0, 'collisions': 7}, {'tx': 22, 'success': 5, 'collisions': 17}, {'tx': 17, 'success': 6, 'collisions': 11}, {'tx': 21, 'success': 6, 'collisions': 15}, {'tx': 30, 'success': 14, 'collisions': 16}, {'tx': 42, 'success': 19, 'collisions': 23}, {'tx': 6, 'success': 0, 'collisions': 6}, {'tx': 39, 'success': 17, 'collisions': 22}, {'tx': 27, 'success': 9, 'collisions': 18}, {'tx': 45, 'success': 21, 'collisions': 24}, {'tx': 21, 'success': 6, 'collisions': 15}, {'tx': 9, 'success': 1, 'collisions': 8}, {'tx': 21, 'success': 5, 'collisions': 16}, {'tx': 8, 'success': 1, 'collisions': 7}, {'tx': 9, 'success': 1, 'collisions': 8}, {'tx': 46, 'success': 20, 'collisions': 26}, {'tx': 26, 'success': 13, 'collisions': 13}, {'tx': 30, 'success': 12, 'collisions': 18}, {'tx': 41, 'success': 21, 'collisions': 20}, {'tx': 26, 'success': 8, 'collisions': 18}, {'tx': 9, 'success': 1, 'collisions': 8}, {'tx': 19, 'success': 4, 'collisions': 15}, {'tx': 22, 'success': 7, 'collisions': 15}, {'tx': 28, 'success': 9, 'collisions': 19}, {'tx': 35, 'success': 16, 'collisions': 19}, {'tx': 6, 'success': 0, 'collisions': 6}, {'tx': 9, 'success': 1, 'collisions': 8}, {'tx': 6, 'success': 0, 'collisions': 6}, {'tx': 29, 'success': 9, 'collisions': 20}, {'tx': 25, 'success': 8, 'collisions': 17}, {'tx': 21, 'success': 6, 'collisions': 15}, {'tx': 11, 'success': 3, 'collisions': 8}, {'tx': 41, 'success': 23, 'collisions': 18}, {'tx': 22, 'success': 10, 'collisions': 12}, {'tx': 18, 'success': 6, 'collisions': 12}, {'tx': 19, 'success': 4, 'collisions': 15}, {'tx': 48, 'success': 25, 'collisions': 23}, {'tx': 34, 'success': 15, 'collisions': 19}, {'tx': 6, 'success': 0, 'collisions': 6}, {'tx': 6, 'success': 0, 'collisions': 6}]"
217,40,18,869,311,558,0.6421173762945915,0.3578826237054085,0.5598,"[{'tx': 18, 'success': 5, 'collisions': 13}, {'tx': 20, 'success': 8, 'collisions': 12}, {'tx': 7, 'success': 0, 'collisions': 7}, {'tx': 33, 'success': 16, 'collisions': 17}, {'tx': 30, 'success': 12, 'collisions': 18}, {'tx': 36, 'success': 16, 'collisions': 20}, {'tx': 6, 'success': 0, 'collisions': 6}, {'tx': 12, 'success': 2, 'collisions': 10}, {'tx': 13, 'success': 3, 'collisions': 10}, {'tx': 27, 'success': 12, 'collisions': 15}, {'tx': 11, 'success': 1, 'collisions': 10}, {'tx': 10, 'success': 2, 'collisions': 8}, {'tx': 21, 'success': 6, 'collisions': 15}, {'tx': 23, 'success': 7, 'collisions': 16}, {'tx': 16, 'success': 3, 'collisions': 13}, {'tx': 6, 'success': 0, 'collisions': 6}, {'tx': 10, 'success': 3, 'collisions': 7}, {'tx': 10, 'success': 2, 'collisions': 8}, {'tx': 19, 'success': 5, 'collisions': 14}, {'tx': 24, 'success': 8, 'collisions': 16}, {'tx': 29, 'success': 12, 'collisions': 17}, {'tx': 24, 'success': 8, 'collisions': 16}, {'tx': 6, 'success': 0, 'collisions': 6}, {'tx': 18, 'success': 5, 'collisions': 13}, {'tx': 6, 'success': 0, 'collisions': 6}, {'tx': 30, 'success': 11, 'collisions': 19}, {'tx': 43, 'success': 19, 'collisions': 24}, {'tx': 27, 'success': 11, 'collisions': 16}, {'tx': 44, 'success': 21, 'collisions': 23}, {'tx': 20, 'success': 5, 'collisions': 15}, {'tx': 15, 'success': 4, 'collisions': 11}, {'tx': 33, 'success': 18, 'collisions': 15}, {'tx': 32, 'success': 12, 'collisions': 20}, {'tx': 38, 'success': 18, 'collisions': 20}, {'tx': 42, 'success': 20, 'collisions': 22}, {'tx': 12, 'success': 2, 'collisions': 10}, {'tx': 33, 'success': 14, 'collisions': 19}, {'tx': 6, 'success': 0, 'collisions': 6}, {'tx': 40, 'success': 14, 'collisions': 26}, {'tx': 19, 'success': 6, 'collisions': 13}]"
218,40,19,814,299,515,0.6326781326781327,0.36732186732186733,0.5681,"[{'tx': 23, 'success': 9, 'collisions': 14}, {'tx': 11, 'success': 2, 'collisions': 9}, {'tx': 29, 'success': 13, 'collisions': 16}, {'tx': 6, 'success': 0, 'collisions': 6}, {'tx': 8, 'success': 1, 'collisions': 7}, {'tx': 23, 'success': 6, 'collisions': 17}, {'tx': 6, 'success': 0, 'collisions': 6}, {'tx': 6, 'success': 0, 'collisions': 6}, {'tx': 17, 'success': 6, 'collisions': 11}, {'tx': 35, 'success': 14, 'collisions': 21}, {'tx': 27, 'success': 10, 'collisions': 17}, {'tx': 25, 'success': 6, 'collisions': 19}, {'tx': 50, 'success': 25, 'collisions': 25}, {'tx': 6, 'success': 0, 'collisions': 6}, {'tx': 29, 'success': 10, 'collisions': 19}, {'tx': 16, 'success': 6, 'collisions': 10}, {'tx': 6, 'success': 0, 'collisions': 6}, {'tx': 8, 'success': 2, 'collisions': 6}, {'tx': 7, 'success': 0, 'collisions': 7}, {'tx': 12, 'success': 3, 'collisions': 9}, {'tx': 29, 'success': 14, 'collisions': 15}, {'tx': 14, 'success': 5, 'collisions': 9}, {'tx': 18, 'success': 4, 'collisions': 14}, {'tx': 37, 'success': 21, 'collisions': 16}, {'tx': 17, 'success': 4, 'collisions': 13}, {'tx': 22, 'success': 8, 'collisions': 14}, {'tx': 26, 'success': 10, 'collisions': 16}, {'tx': 30, 'success': 12, 'collisions': 18}, {'tx': 6, 'success': 0, 'collisions': 6}, {'tx': 11, 'success': 2, 'collisions': 9}, {'tx': 13, 'success': 2, 'collisions': 11}, {'tx': 6, 'success': 0, 'collisions': 6}, {'tx': 33, 'success': 15, 'collisions': 18}, {'tx': 43, 'success': 23, 'collisions': 20}, {'tx': 11, 'success': 3, 'collisions': 8}, {'tx': 19, 'success': 7, 'collisions': 12}, {'tx': 40, 'success': 19, 'collisions': 21}, {'tx': 27, 'success': 12, 'collisions': 15}, {'tx': 42, 'success': 18, 'collisions': 24}, {'tx': 20, 'success': 7, 'collisions': 13}]"
219,40,20,787,278,509,0.6467598475222364,0.35324015247776364,0.556,"[{'tx': 6, 'success': 0, 'collisions': 6}, {'tx': 10, 'success': 2, 'collisions': 8}, {'tx': 21, 'success': 7, 'collisions': 14}, {'tx': 18, 'success': 6, 'collisions': 12}, {'tx': 31, 'success': 16, 'collisions': 15}, {'tx': 6, 'success': 0, 'collisions': 6}, {'tx': 36, 'success': 17, 'collisions': 19}, {'tx': 6, 'success': 0, 'collisions': 6}, {'tx': 7, 'success': 1, 'collisions': 6}, {'tx': 24, 'success': 8, 'collisions': 16}, {'tx': 13, 'success': 2, 'collisions': 11}, {'tx': 9, 'success': 2, 'collisions': 7}, {'tx': 24, 'success': 11, 'collisions': 13}, {'tx': 6, 'success': 0, 'collisions': 6}, {'tx': 31, 'success': 12, 'collisions': 19}, {'tx': 12, 'success': 2, 'collisions': 10}, {'tx': 38, 'success': 17, 'collisions': 21}, {'tx': 38, 'success': 13, 'collisions': 25}, {'tx': 26, 'success': 10, 'collisions': 16}, {'tx': 39, 'success': 17, 'collisions': 22}, {'tx': 37, 'success': 16, 'collisions': 21}, {'tx': 10, 'success': 1, 'collisions': 9}, {'tx': 28, 'success': 12, 'collisions': 16}, {'tx': 7, 'success': 1, 'collisions': 6}, {'tx': 9, 'success': 1, 'collisions': 8}, {'tx': 24, 'success': 10, 'collisions': 14}, {'tx': 19, 'success': 7, 'collisions': 12}, {'tx': 31, 'success': 14, 'collisions': 17}, {'tx': 6, 'success': 0, 'collisions': 6}, {'tx': 22, 'success': 8, 'collisions': 14}, {'tx': 28, 'success': 14, 'collisions': 14}, {'tx': 21, 'success': 8, 'collisions': 13}, {'tx': 9, 'success': 2, 'collisions': 7}, {'tx': 6, 'success': 0, 'collisions': 6}, {'tx': 17, 'success': 5, 'collisions': 12}, {'tx': 37, 'success': 15, 'collisions': 22}, {'tx': 5, 'success': 0, 'collisions': 5}, {'tx': 32, 'success': 12, 'collisions': 20}, {'tx': 18, 'success': 4, 'collisions': 14}, {'tx': 20, 'success': 5, 'collisions': 15}]"
220,40,21,777,259,518,0.6666666666666666,0.3333333333333333,0.5439,"[{'tx': 9, 'success': 1, 'collisions': 8}, {'tx': 25, 'success': 9, 'collisions': 16}, {'tx': 18, 'success': 4, 'collisions': 14}, {'tx': 19, 'success': 6, 'collisions': 13}, {'tx': 21, 'success': 6, 'collisions': 15}, {'tx': 18, 'success': 8, 'collisions': 10}, {'tx': 11, 'success': 1, 'collisions': 10}, {'tx': 17, 'success': 6, 'collisions': 11}, {'tx': 21, 'success': 6, 'collisions': 15}, {'tx': 37, 'success': 16, 'collisions': 21}, {'tx': 15, 'success': 2, 'collisions': 13}, {'tx': 6, 'success': 0, 'collisions': 6}, {'tx': 35, 'success': 17, 'collisions': 18}, {'tx': 44, 'success': 20, 'collisions': 24}, {'tx': 10, 'success': 1, 'collisions': 9}, {'tx': 6, 'success': 0, 'collisions': 6}, {'tx': 20, 'success': 8, 'collisions': 12}, {'tx': 10, 'success': 1, 'collisions': 9}, {'tx': 25, 'success': 12, 'collisions': 13}, {'tx': 39, 'success': 19, 'collisions': 20}, {'tx': 44, 'success': 17, 'collisions': 27}, {'tx': 16, 'success': 4, 'collisions': 12}, {'tx': 15, 'success': 3, 'collisions': 12}, {'tx': 38, 'success': 15, 'collisions': 23}, {'tx': 27, 'success': 10, 'collisions': 17}, {'tx': 6, 'success': 0, 'collisions': 6}, {'tx': 17, 'success': 5, 'collisions': 12}, {'tx': 6, 'success': 0, 'collisions': 6}, {'tx': 24, 'success': 8, 'collisions': 16}, {'tx': 5, 'success': 0, 'collisions': 5}, {'tx': 10, 'success': 2, 'collisions': 8}, {'tx': 20, 'success': 6, 'collisions': 14}, {'tx': 6, 'success': 0, 'collisions': 6}, {'tx': 8, 'success': 2, 'collisions': 6}, {'tx': 24, 'success': 9, 'collisions': 15}, {'tx': 17, 'success': 5, 'collisions': 12}, {'tx': 13, 'success': 3, 'collisions': 10}, {'tx': 15, 'success': 3, 'collisions': 12}, {'tx': 27, 'success': 10, 'collisions': 17}, {'tx': 33, 'success': 14, 'collisions': 19}]"
221,40,22,737,251,486,0.6594301221166893,0.3405698778833107,0.5522,"[{'tx': 16, 'success': 6, 'collisions': 10}, {'tx': 34, 'success': 13, 'collisions': 21}, {'tx': 25, 'success': 9, 'collisions': 16}, {'tx': 21, 'success': 9, 'collisions': 12}, {'tx': 13, 'success': 3, 'collisions': 10}, {'tx': 23, 'success': 9, 'collisions': 14}, {'tx': 14, 'success': 3, 'collisions': 11}, {'tx': 9, 'success': 2, 'collisions': 7}, {'tx': 17, 'success': 4, 'collisions': 13}, {'tx': 23, 'success': 10, 'collisions': 13}, {'tx': 6, 'success': 0, 'collisions': 6}, {'tx': 17, 'success': 5, 'collisions': 12}, {'tx': 29, 'success': 9, 'collisions': 20}, {'tx': 10, 'success': 2, 'collisions': 8}, {'tx': 35, 'success': 16, 'collisions': 19}, {'tx': 27, 'success': 11, 'collisions': 16}, {'tx': 20, 'success': 6, 'collisions': 14}, {'tx': 18, 'success': 5, 'collisions': 13}, {'tx': 29, 'success': 11, 'collisions': 18}, {'tx': 11, 'success': 3, 'collisions': 8}, {'tx': 10, 'success': 1, 'collisions': 9}, {'tx': 6, 'success': 0, 'collisions': 6}, {'tx': 9, 'success': 1, 'collisions': 8}, {'tx': 27, 'success': 11, 'collisions': 16}, {'tx': 5, 'success': 0, 'collisions': 5}, {'tx': 13, 'success': 3, 'collisions': 10}, {'tx': 9, 'success': 3, 'collisions': 6}, {'tx': 32, 'success': 13, 'collisions': 19}, {'tx': 5, 'success': 0, 'collisions': 5}, {'tx': 9, 'success': 3, 'collisions': 6}, {'tx': 27, 'success': 13, 'collisions': 14}, {'tx': 27, 'success': 10, 'collisions': 17}, {'tx': 24, 'success': 8, 'collisions': 16}, {'tx': 17, 'success': 5, 'collisions': 12}, {'tx': 39, 'success': 20, 'collisions': 19}, {'tx': 15, 'success': 3, 'collisions': 12}, {'tx': 21, 'success': 8, 'collisions': 13}, {'tx': 15, 'success': 4, 'collisions': 11}, {'tx': 19, 'success': 7, 'collisions': 12}, {'tx': 11, 'success': 2, 'collisions': 9}]"
222,40,23,695,237,458,0.6589928057553956,0.3410071942446043,0.5451,"[{'tx': 17, 'success': 3, 'collisions': 14}, {'tx': 22, 'success': 8, 'collisions': 14}, {'tx': 40, 'success': 18, 'collisions': 22}, {'tx': 41, 'success': 23, 'collisions': 18}, {'tx': 25, 'success': 8, 'collisions': 17}, {'tx': 9, 'success': 1, 'collisions': 8}, {'tx': 6, 'success': 0, 'collisions': 6}, {'tx': 6, 'success': 0, 'collisions': 6}, {'tx': 8, 'success': 1, 'collisions': 7}, {'tx': 12, 'success': 3, 'collisions': 9}, {'tx': 20, 'success': 7, 'collisions': 13}, {'tx': 10, 'success': 1, 'collisions': 9}, {'tx': 23, 'success': 9, 'collisions': 14}, {'tx': 7, 'success': 1, 'collisions': 6}, {'tx': 22, 'success': 7, 'collisions': 15}, {'tx': 5, 'success': 0, 'collisions': 5}, {'tx': 5, 'success': 0, 'collisions': 5}, {'tx': 31, 'success': 14, 'collisions': 17}, {'tx': 6, 'success': 0, 'collisions': 6}, {'tx': 10, 'success': 1, 'collisions': 9}, {'tx': 6, 'success': 0, 'collisions': 6}, {'tx': 5, 'success': 0, 'collisions': 5}, {'tx': 9, 'success': 1, 'collisions': 8}, {'tx': 6, 'success': 0, 'collisions': 6}, {'tx': 41, 'success': 18, 'collisions': 23}, {'tx': 35, 'success': 18, 'collisions': 17}, {'tx': 12, 'success': 4, 'collisions': 8}, {'tx': 15, 'success': 4, 'collisions': 11}, {'tx': 18, 'success': 5, 'collisions': 13}, {'tx': 10, 'success': 1, 'collisions': 9}, {'tx': 7, 'success': 0, 'collisions': 7}, {'tx': 18, 'success': 5, 'collisions': 13}, {'tx': 34, 'success': 14, 'collisions': 20}, {'tx': 43, 'success': 23, 'collisions': 20}, {'tx': 14, 'success': 4, 'collisions': 10}, {'tx': 30, 'success': 15, 'collisions': 15}, {'tx': 13, 'success': 4, 'collisions': 9}, {'tx': 18, 'success': 7, 'collisions': 11}, {'tx': 27, 'success': 8, 'collisions': 19}, {'tx': 9, 'success': 1, 'collisions': 8}]"
223,40,24,690,217,473,0.6855072463768116,0.3144927536231884,0.5208,"[{'tx': 23, 'success': 8, 'collisions': 15}, {'tx': 12, 'success': 3, 'collisions': 9}, {'tx': 5, 'success': 0, 'collisions': 5}, {'tx': 23, 'success': 8, 'collisions': 15}, {'tx': 12, 'success': 3, 'collisions': 9}, {'tx': 7, 'success': 0, 'collisions': 7}, {'tx': 14, 'success': 2, 'collisions': 12}, {'tx': 5, 'success': 0, 'collisions': 5}, {'tx': 37, 'success': 19, 'collisions': 18}, {'tx': 21, 'success': 7, 'collisions': 14}, {'tx': 32, 'success': 11, 'collisions': 21}, {'tx': 26, 'success': 11, 'collisions': 15}, {'tx': 40, 'success': 18, 'collisions': 22}, {'tx': 23, 'success': 8, 'collisions': 15}, {'tx': 24, 'success': 8, 'collisions': 16}, {'tx': 5, 'success': 0, 'collisions': 5}, {'tx': 6, 'success': 0, 'collisions': 6}, {'tx': 16, 'success': 5, 'collisions': 11}, {'tx': 35, 'success': 15, 'collisions': 20}, {'tx': 22, 'success': 6, 'collisions': 16}, {'tx': 10, 'success': 2, 'collisions': 8}, {'tx': 17, 'success': 5, 'collisions': 12}, {'tx': 21, 'success': 4, 'collisions': 17}, {'tx': 12, 'success': 2, 'collisions': 10}, {'tx': 10, 'success': 1, 'collisions': 9}, {'tx': 16, 'success': 5, 'collisions': 11}, {'tx': 6, 'success': 0, 'collisions': 6}, {'tx': 21, 'success': 6, 'collisions': 15}, {'tx': 17, 'success': 5, 'collisions': 12}, {'tx': 12, 'success': 2, 'collisions': 10}, {'tx': 13, 'success': 6, 'collisions': 7}, {'tx': 19, 'success': 7, 'collisions': 12}, {'tx': 7, 'success': 0, 'collisions': 7}, {'tx': 15, 'success': 7, 'collisions': 8}, {'tx': 22, 'success': 7, 'collisions': 15}, {'tx': 11, 'success': 2, 'collisions': 9}, {'tx': 16, 'success': 3, 'collisions': 13}, {'tx': 30, 'success': 12, 'collisions': 18}, {'tx': 17, 'success': 7, 'collisions': 10}, {'tx': 10, 'success': 2, 'collisions': 8}]"
224,40,25,649,209,440,0.6779661016949152,0.3220338983050847,0.5225,"[{'tx': 24, 'success': 9, 'collisions': 15}, {'tx': 21, 'success': 8, 'collisions': 13}, {'tx': 13, 'success': 2, 'collisions': 11}, {'tx': 7, 'success': 0, 'collisions': 7}, {'tx': 9, 'success': 1, 'collisions': 8}, {'tx': 17, 'success': 6, 'collisions': 11}, {'tx': 13, 'success': 6, 'collisions': 7}, {'tx': 30, 'success': 11, 'collisions': 19}, {'tx': 28, 'success': 14, 'collisions': 14}, {'tx': 9, 'success': 2, 'collisions': 7}, {'tx': 10, 'success': 2, 'collisions': 8}, {'tx': 20, 'success': 9, 'collisions': 11}, {'tx': 18, 'success': 7, 'collisions': 11}, {'tx': 11, 'success': 2, 'collisions': 9}, {'tx': 6, 'success': 0, 'collisions': 6}, {'tx': 25, 'success': 8, 'collisions': 17}, {'tx': 24, 'success': 11, 'collisions': 13}, {'tx': 36, 'success': 16, 'collisions': 20}, {'tx': 5, 'success': 0, 'collisions': 5}, {'tx': 17, 'success': 8, 'collisions': 9}, {'tx': 17, 'success': 4, 'collisions': 13}, {'tx': 35, 'success': 13, 'collisions': 22}, {'tx': 13, 'success': 3, 'collisions': 10}, {'tx': 7, 'success': 0, 'collisions': 7}, {'tx': 22, 'success': 7, 'collisions': 15}, {'tx': 23, 'success': 8, 'collisions': 15}, {'tx': 13, 'success': 3, 'collisions': 10}, {'tx': 10, 'success': 1, 'collisions': 9}, {'tx': 5, 'success': 0, 'collisions': 5}, {'tx': 13, 'success': 2, 'collisions': 11}, {'tx': 6, 'success': 0, 'collisions': 6}, {'tx': 26, 'success': 10, 'collisions': 16}, {'tx': 19, 'success': 4, 'collisions': 15}, {'tx': 6, 'success': 0, 'collisions': 6}, {'tx': 15, 'success': 4, 'collisions': 11}, {'tx': 24, 'success': 9, 'collisions': 15}, {'tx': 5, 'success': 0, 'collisions': 5}, {'tx': 13, 'success': 5, 'collisions': 8}, {'tx': 28, 'success': 14, 'collisions': 14}, {'tx': 6, 'success': 0, 'collisions': 6}]"
225,40,26,633,217,416,0.6571879936808847,0.34281200631911535,0.5642,"[{'tx': 17, 'success': 4, 'collisions': 13}, {'tx': 20, 'success': 8, 'collisions': 12}, {'tx': 6, 'success': 0, 'collisions': 6}, {'tx': 9, 'success': 1, 'collisions': 8}, {'tx': 18, 'success': 7, 'collisions': 11}, {'tx': 29, 'success': 11, 'collisions': 18}, {'tx': 5, 'success': 0, 'collisions': 5}, {'tx': 29, 'success': 11, 'collisions': 18}, {'tx': 17, 'success': 9, 'collisions': 8}, {'tx': 16, 'success': 6, 'collisions': 10}, {'tx': 18, 'success': 6, 'collisions': 12}, {'tx': 12, 'success': 3, 'collisions': 9}, {'tx': 15, 'success': 5, 'collisions': 10}, {'tx': 19, 'success': 8, 'collisions': 11}, {'tx': 23, 'success': 10, 'collisions': 13}, {'tx': 8, 'success': 1, 'collisions': 7}, {'tx': 9, 'success': 1, 'collisions': 8}, {'tx': 24, 'success': 8, 'collisions': 16}, {'tx': 27, 'success': 12, 'collisions': 15}, {'tx': 7, 'success': 0, 'collisions': 7}, {'tx': 31, 'success': 12, 'collisions': 19}, {'tx': 16, 'success': 5, 'collisions': 11}, {'tx': 25, 'success': 16, 'collisions': 9}, {'tx': 11, 'success': 2, 'collisions': 9}, {'tx': 9, 'success': 1, 'collisions': 8}, {'tx': 21, 'success': 9, 'collisions': 12}, {'tx': 6, 'success': 0, 'collisions': 6}, {'tx': 22, 'success': 9, 'collisions': 13}, {'tx': 5, 'success': 0, 'collisions': 5}, {'tx': 10, 'success': 2, 'collisions': 8}, {'tx': 7, 'success': 1, 'collisions': 6}, {'tx': 5, 'success': 0, 'collisions': 5}, {'tx': 19, 'success': 7, 'collisions': 12}, {'tx': 20, 'success': 7, 'collisions': 13}, {'tx': 20, 'success': 7, 'collisions': 13}, {'tx': 20, 'success': 7, 'collisions': 13}, {'tx': 23, 'success': 13, 'collisions': 10}, {'tx': 6, 'success': 0, 'collisions': 6}, {'tx': 15, 'success': 5, 'collisions': 10}, {'tx': 14, 'success': 3, 'collisions': 11}]"
226,40,27,601,204,397,0.6605657237936772,0.33943427620632277,0.5508,"[{'tx': 20, 'success': 8, 'collisions': 12}, {'tx': 6, 'success': 0, 'collisions': 6}, {'tx': 21, 'success': 8, 'collisions': 13}, {'tx': 18, 'success': 5, 'collisions': 13}, {'tx': 11, 'success': 2, 'collisions': 9}, {'tx': 24, 'success': 11, 'collisions': 13}, {'tx': 26, 'success': 9, 'collisions': 17}, {'tx': 6, 'success': 0, 'collisions': 6}, {'tx': 25, 'success': 11, 'collisions': 14}, {'tx': 15, 'success': 4, 'collisions': 11}, {'tx': 6, 'success': 0, 'collisions': 6}, {'tx': 5, 'success': 0, 'collisions': 5}, {'tx': 12, 'success': 3, 'collisions': 9}, {'tx': 6, 'success': 0, 'collisions': 6}, {'tx': 19, 'success': 5, 'collisions': 14}, {'tx': 17, 'success': 7, 'collisions': 10}, {'tx': 11, 'success': 2, 'collisions': 9}, {'tx': 26, 'success': 14, 'collisions': 12}, {'tx': 5, 'success': 0, 'collisions': 5}, {'tx': 11, 'success': 3, 'collisions': 8}, {'tx': 22, 'success': 9, 'collisions': 13}, {'tx': 14, 'success': 6, 'collisions': 8}, {'tx': 19, 'success': 8, 'collisions': 11}, {'tx': 5, 'success': 0, 'collisions': 5}, {'tx': 16, 'success': 5, 'collisions': 11}, {'tx': 23, 'success': 10, 'collisions': 13}, {'tx': 6, 'success': 0, 'collisions': 6}, {'tx': 43, 'success': 25, 'collisions': 18}, {'tx': 20, 'success': 6, 'collisions': 14}, {'tx': 5, 'success': 0, 'collisions': 5}, {'tx': 9, 'success': 1, 'collisions': 8}, {'tx': 23, 'success': 7, 'collisions': 16}, {'tx': 5, 'success': 0, 'collisions': 5}, {'tx': 13, 'success': 5, 'collisions': 8}, {'tx': 7, 'success': 1, 'collisions': 6}, {'tx': 21, 'success': 7, 'collisions': 14}, {'tx': 14, 'success': 4, 'collisions': 10}, {'tx': 26, 'success': 11, 'collisions': 15}, {'tx': 13, 'success': 5, 'collisions': 8}, {'tx': 7, 'success': 2, 'collisions': 5}]"
227,40,28,598,191,407,0.6806020066889632,0.3193979933110368,0.5348,"[{'tx': 16, 'success': 5, 'collisions': 11}, {'tx': 29, 'success': 14, 'collisions': 15}, {'tx': 9, 'success': 1, 'collisions': 8}, {'tx': 15, 'success': 6, 'collisions': 9}, {'tx': 6, 'success': 0, 'collisions': 6}, {'tx': 19, 'success': 7, 'collisions': 12}, {'tx': 13, 'success': 2, 'collisions': 11}, {'tx': 22, 'success': 9, 'collisions': 13}, {'tx': 21, 'success': 8, 'collisions': 13}, {'tx': 5, 'success': 0, 'collisions': 5}, {'tx': 18, 'success': 8, 'collisions': 10}, {'tx': 26, 'success': 11, 'collisions': 15}, {'tx': 28, 'success': 12, 'collisions': 16}, {'tx': 21, 'success': 8, 'collisions': 13}, {'tx': 21, 'success': 9, 'collisions': 12}, {'tx': 6, 'success': 0, 'collisions': 6}, {'tx': 18, 'success': 6, 'collisions': 12}, {'tx': 14, 'success': 5, 'collisions': 9}, {'tx': 13, 'success': 2, 'collisions': 11}, {'tx': 5, 'success': 0, 'collisions': 5}, {'tx': 14, 'success': 3, 'collisions': 11}, {'tx': 6, 'success': 0, 'collisions': 6}, {'tx': 21, 'success': 11, 'collisions': 10}, {'tx': 23, 'success': 10, 'collisions': 13}, {'tx': 11, 'success': 3, 'collisions': 8}, {'tx': 10, 'success': 3, 'collisions': 7}, {'tx': 26, 'success': 10, 'collisions': 16}, {'tx': 10, 'success': 3, 'collisions': 7}, {'tx': 14, 'success': 4, 'collisions': 10}, {'tx': 13, 'success': 3, 'collisions': 10}, {'tx': 28, 'success': 12, 'collisions': 16}, {'tx': 10, 'success': 1, 'collisions': 9}, {'tx': 12, 'success': 2, 'collisions': 10}, {'tx': 5, 'success': 0, 'collisions': 5}, {'tx': 12, 'success': 2, 'collisions': 10}, {'tx': 20, 'success': 5, 'collisions': 15}, {'tx': 13, 'success': 2, 'collisions': 11}, {'tx': 12, 'success': 3, 'collisions': 9}, {'tx': 8, 'success': 1, 'collisions': 7}, {'tx': 5, 'success': 0, 'collisions': 5}]"
228,40,29,579,187,392,0.6770293609671848,0.3229706390328152,0.5423,"[{'tx': 12, 'success': 2, 'collisions': 10}, {'tx': 14, 'success': 3, 'collisions': 11}, {'tx': 8, 'success': 1, 'collisions': 7}, {'tx': 16, 'success': 5, 'collisions': 11}, {'tx': 25, 'success': 10, 'collisions': 15}, {'tx': 5, 'success': 0, 'collisions': 5}, {'tx': 18, 'success': 7, 'collisions': 11}, {'tx': 13, 'success': 3, 'collisions': 10}, {'tx': 32, 'success': 20, 'collisions': 12}, {'tx': 22, 'success': 8, 'collisions': 14}, {'tx': 22, 'success': 11, 'collisions': 11}, {'tx': 9, 'success': 1, 'collisions': 8}, {'tx': 14, 'success': 4, 'collisions': 10}, {'tx': 27, 'success': 13, 'collisions': 14}, {'tx': 5, 'success': 0, 'collisions': 5}, {'tx': 18, 'success': 7, 'collisions': 11}, {'tx': 8, 'success': 1, 'collisions': 7}, {'tx': 14, 'success': 4, 'collisions': 10}, {'tx': 26, 'success': 11, 'collisions': 15}, {'tx': 20, 'success': 7, 'collisions': 13}, {'tx': 15, 'success': 5, 'collisions': 10}, {'tx': 10, 'success': 2, 'collisions': 8}, {'tx': 5, 'success': 0, 'collisions': 5}, {'tx': 5, 'success': 0, 'collisions': 5}, {'tx': 6, 'success': 0, 'collisions': 6}, {'tx': 6, 'success': 0, 'collisions': 6}, {'tx': 16, 'success': 3, 'collisions': 13}, {'tx': 14, 'success': 6, 'collisions': 8}, {'tx': 11, 'success': 2, 'collisions': 9}, {'tx': 5, 'success': 0, 'collisions': 5}, {'tx': 6, 'success': 0, 'collisions': 6}, {'tx': 17, 'success': 6, 'collisions': 11}, {'tx': 24, 'success': 9, 'collisions': 15}, {'tx': 10, 'success': 1, 'collisions': 9}, {'tx': 13, 'success': 3, 'collisions': 10}, {'tx': 17, 'success': 6, 'collisions': 11}, {'tx': 18, 'success': 8, 'collisions': 10}, {'tx': 20, 'success': 6, 'collisions': 14}, {'tx': 5, 'success': 0, 'collisions': 5}, {'tx': 28, 'success': 12, 'collisions': 16}]"
229,40,30,576,169,407,0.7065972222222222,0.2934027777777778,0.507,"[{'tx': 28, 'success': 11, 'collisions': 17}, {'tx': 13, 'success': 2, 'collisions': 11}, {'tx': 5, 'success': 0, 'collisions': 5}, {'tx': 5, 'success': 0, 'collisions': 5}, {'tx': 25, 'success': 9, 'collisions': 16}, {'tx': 5, 'success': 0, 'collisions': 5}, {'tx': 6, 'success': 0, 'collisions': 6}, {'tx': 10, 'success': 1, 'collisions': 9}, {'tx': 16, 'success': 3, 'collisions': 13}, {'tx': 21, 'success': 7, 'collisions': 14}, {'tx': 19, 'success': 8, 'collisions': 11}, {'tx': 19, 'success': 7, 'collisions': 12}, {'tx': 26, 'success': 12, 'collisions': 14}, {'tx': 9, 'success': 2, 'collisions': 7}, {'tx': 24, 'success': 10, 'collisions': 14}, {'tx': 19, 'success': 6, 'collisions': 13}, {'tx': 5, 'success': 0, 'collisions': 5}, {'tx': 27, 'success': 13, 'collisions': 14}, {'tx': 24, 'success': 8, 'collisions': 16}, {'tx': 15, 'success': 3, 'collisions': 12}, {'tx': 16, 'success': 3, 'collisions': 13}, {'tx': 20, 'success': 6, 'collisions': 14}, {'tx': 8, 'success': 1, 'collisions': 7}, {'tx': 21, 'success': 5, 'collisions': 16}, {'tx': 21, 'success': 7, 'collisions': 14}, {'tx': 5, 'success': 0, 'collisions': 5}, {'tx': 15, 'success': 5, 'collisions': 10}, {'tx': 16, 'success': 5, 'collisions': 11}, {'tx': 11, 'success': 2, 'collisions': 9}, {'tx': 11, 'success': 3, 'collisions': 8}, {'tx': 16, 'success': 5, 'collisions': 11}, {'tx': 5, 'success': 0, 'collisions': 5}, {'tx': 17, 'success': 7, 'collisions': 10}, {'tx': 5, 'success': 0, 'collisions': 5}, {'tx': 16, 'success': 4, 'collisions': 12}, {'tx': 12, 'success': 4, 'collisions': 8}, {'tx': 11, 'success': 3, 'collisions': 8}, {'tx': 7, 'success': 1, 'collisions': 6}, {'tx': 13, 'success': 5, 'collisions': 8}, {'tx': 9, 'success': 1, 'collisions': 8}]"
230,40,31,528,181,347,0.6571969696969697,0.3428030303030303,0.5611,"[{'tx': 16, 'success': 6, 'collisions': 10}, {'tx': 6, 'success': 1, 'collisions': 5}, {'tx': 8, 'success': 2, 'collisions': 6}, {'tx': 16, 'success': 5, 'collisions': 11}, {'tx': 5, 'success': 0, 'collisions': 5}, {'tx': 7, 'success': 1, 'collisions': 6}, {'tx': 15, 'success': 6, 'collisions': 9}, {'tx': 17, 'success': 5, 'collisions': 12}, {'tx': 11, 'success': 3, 'collisions': 8}, {'tx': 17, 'success': 7, 'collisions': 10}, {'tx': 19, 'success': 10, 'collisions': 9}, {'tx': 29, 'success': 12, 'collisions': 17}, {'tx': 14, 'success': 5, 'collisions': 9}, {'tx': 21, 'success': 12, 'collisions': 9}, {'tx': 25, 'success': 14, 'collisions': 11}, {'tx': 21, 'success': 9, 'collisions': 12}, {'tx': 20, 'success': 8, 'collisions': 12}, {'tx': 13, 'success': 4, 'collisions': 9}, {'tx': 5, 'success': 0, 'collisions': 5}, {'tx': 23, 'success': 10, 'collisions': 13}, {'tx': 15, 'success': 5, 'collisions': 10}, {'tx': 8, 'success': 2, 'collisions': 6}, {'tx': 25, 'success': 12, 'collisions': 13}, {'tx': 5, 'success': 0, 'collisions': 5}, {'tx': 14, 'success': 3, 'collisions': 11}, {'tx': 12, 'success': 4, 'collisions': 8}, {'tx': 8, 'success': 1, 'collisions': 7}, {'tx': 10, 'success': 2, 'collisions': 8}, {'tx': 5, 'success': 0, 'collisions': 5}, {'tx': 13, 'success': 3, 'collisions': 10}, {'tx': 30, 'success': 14, 'collisions': 16}, {'tx': 5, 'success': 0, 'collisions': 5}, {'tx': 7, 'success': 0, 'collisions': 7}, {'tx': 10, 'success': 3, 'collisions': 7}, {'tx': 9, 'success': 2, 'collisions': 7}, {'tx': 5, 'success': 0, 'collisions': 5}, {'tx': 5, 'success': 0, 'collisions': 5}, {'tx': 20, 'success': 9, 'collisions': 11}, {'tx': 5, 'success': 0, 'collisions': 5}, {'tx': 9, 'success': 1, 'collisions': 8}]"
231,40,32,526,162,364,0.6920152091254753,0.30798479087452474,0.5184,"[{'tx': 5, 'success': 0, 'collisions': 5}, {'tx': 17, 'success': 5, 'collisions': 12}, {'tx': 8, 'success': 1, 'collisions': 7}, {'tx': 5, 'success': 0, 'collisions': 5}, {'tx': 20, 'success': 8, 'collisions': 12}, {'tx': 7, 'success': 1, 'collisions': 6}, {'tx': 10, 'success': 3, 'collisions': 7}, {'tx': 22, 'success': 7, 'collisions': 15}, {'tx': 17, 'success': 4, 'collisions': 13}, {'tx': 15, 'success': 4, 'collisions': 11}, {'tx': 16, 'success': 5, 'collisions': 11}, {'tx': 12, 'success': 3, 'collisions': 9}, {'tx': 12, 'success': 2, 'collisions': 10}, {'tx': 5, 'success': 0, 'collisions': 5}, {'tx': 15, 'success': 5, 'collisions': 10}, {'tx': 22, 'success': 11, 'collisions': 11}, {'tx': 5, 'success': 0, 'collisions': 5}, {'tx': 9, 'success': 1, 'collisions': 8}, {'tx': 5, 'success': 0, 'collisions': 5}, {'tx': 9, 'success': 1, 'collisions': 8}, {'tx': 18, 'success': 8, 'collisions': 10}, {'tx': 5, 'success': 0, 'collisions': 5}, {'tx': 6, 'success': 0, 'collisions': 6}, {'tx': 20, 'success': 9, 'collisions': 11}, {'tx': 26, 'success': 13, 'collisions': 13}, {'tx': 5, 'success': 0, 'collisions': 5}, {'tx': 25, 'success': 9, 'collisions': 16}, {'tx': 29, 'success': 14, 'collisions': 15}, {'tx': 10, 'success': 4, 'collisions': 6}, {'tx': 11, 'success': 3, 'collisions': 8}, {'tx': 11, 'success': 3, 'collisions': 8}, {'tx': 11, 'success': 4, 'collisions': 7}, {'tx': 26, 'success': 11, 'collisions': 15}, {'tx': 15, 'success': 3, 'collisions': 12}, {'tx': 13, 'success': 5, 'collisions': 8}, {'tx': 16, 'success': 6, 'collisions': 10}, {'tx': 13, 'success': 3, 'collisions': 10}, {'tx': 9, 'success': 1, 'collisions': 8}, {'tx': 10, 'success': 2, 'collisions': 8}, {'tx': 11, 'success': 3, 'collisions': 8}]"
232,40,33,514,156,358,0.6964980544747081,0.3035019455252918,0.5148,"[{'tx': 6, 'success': 0, 'collisions': 6}, {'tx': 25, 'success': 9, 'collisions': 16}, {'tx': 14, 'success': 6, 'collisions': 8}, {'tx': 9, 'success': 1, 'collisions': 8}, {'tx': 5, 'success': 0, 'collisions': 5}, {'tx': 6, 'success': 0, 'collisions': 6}, {'tx': 5, 'success': 0, 'collisions': 5}, {'tx': 22, 'success': 9, 'collisions': 13}, {'tx': 21, 'success': 7, 'collisions': 14}, {'tx': 9, 'success': 2, 'collisions': 7}, {'tx': 14, 'success': 5, 'collisions': 9}, {'tx': 23, 'success': 10, 'collisions': 13}, {'tx': 22, 'success': 10, 'collisions': 12}, {'tx': 18, 'success': 7, 'collisions': 11}, {'tx': 20, 'success': 8, 'collisions': 12}, {'tx': 15, 'success': 6, 'collisions': 9}, {'tx': 7, 'success': 1, 'collisions': 6}, {'tx': 5, 'success': 0, 'collisions': 5}, {'tx': 14, 'success': 5, 'collisions': 9}, {'tx': 7, 'success': 1, 'collisions': 6}, {'tx': 13, 'success': 4, 'collisions': 9}, {'tx': 18, 'success': 6, 'collisions': 12}, {'tx': 5, 'success': 0, 'collisions': 5}, {'tx': 14, 'success': 5, 'collisions': 9}, {'tx': 17, 'success': 5, 'collisions': 12}, {'tx': 5, 'success': 0, 'collisions': 5}, {'tx': 6, 'success': 1, 'collisions': 5}, {'tx': 7, 'success': 1, 'collisions': 6}, {'tx': 12, 'success': 3, 'collisions': 9}, {'tx': 7, 'success': 1, 'collisions': 6}, {'tx': 23, 'success': 9, 'collisions': 14}, {'tx': 17, 'success': 6, 'collisions': 11}, {'tx': 21, 'success': 8, 'collisions': 13}, {'tx': 17, 'success': 5, 'collisions': 12}, {'tx': 8, 'success': 1, 'collisions': 7}, {'tx': 9, 'success': 2, 'collisions': 7}, {'tx': 13, 'success': 2, 'collisions': 11}, {'tx': 16, 'success': 5, 'collisions': 11}, {'tx': 5, 'success': 0, 'collisions': 5}, {'tx': 14, 'success': 5, 'collisions': 9}]"
233,40,34,488,157,331,0.6782786885245902,0.32172131147540983,0.5338,"[{'tx': 8, 'success': 1, 'collisions': 7}, {'tx': 10, 'success': 2, 'collisions': 8}, {'tx': 5, 'success': 0, 'collisions': 5}, {'tx': 12, 'success': 3, 'collisions': 9}, {'tx': 5, 'success': 0, 'collisions': 5}, {'tx': 11, 'success': 3, 'collisions': 8}, {'tx': 24, 'success': 13, 'collisions': 11}, {'tx': 17, 'success': 5, 'collisions': 12}, {'tx': 5, 'success': 0, 'collisions': 5}, {'tx': 19, 'success': 8, 'collisions': 11}, {'tx': 12, 'success': 3, 'collisions': 9}, {'tx': 11, 'success': 2, 'collisions': 9}, {'tx': 17, 'success': 7, 'collisions': 10}, {'tx': 25, 'success': 10, 'collisions': 15}, {'tx': 6, 'success': 0, 'collisions': 6}, {'tx': 5, 'success': 0, 'collisions': 5}, {'tx': 5, 'success': 0, 'collisions': 5}, {'tx': 17, 'success': 6, 'collisions': 11}, {'tx': 6, 'success': 0, 'collisions': 6}, {'tx': 5, 'success': 0, 'collisions': 5}, {'tx': 6, 'success': 0, 'collisions': 6}, {'tx': 15, 'success': 6, 'collisions': 9}, {'tx': 5, 'success': 0, 'collisions': 5}, {'tx': 6, 'success': 0, 'collisions': 6}, {'tx': 17, 'success': 5, 'collisions': 12}, {'tx': 14, 'success': 6, 'collisions': 8}, {'tx': 14, 'success': 4, 'collisions': 10}, {'tx': 5, 'success': 0, 'collisions': 5}, {'tx': 11, 'success': 4, 'collisions': 7}, {'tx': 21, 'success': 10, 'collisions': 11}, {'tx': 5, 'success': 0, 'collisions': 5}, {'tx': 30, 'success': 14, 'collisions': 16}, {'tx': 25, 'success': 11, 'collisions': 14}, {'tx': 28, 'success': 16, 'collisions': 12}, {'tx': 5, 'success': 0, 'collisions': 5}, {'tx': 18, 'success': 7, 'collisions': 11}, {'tx': 11, 'success': 5, 'collisions': 6}, {'tx': 6, 'success': 1, 'collisions': 5}, {'tx': 16, 'success': 5, 'collisions': 11}, {'tx': 5, 'success': 0, 'collisions': 5}]"
234,40,35,493,146,347,0.7038539553752535,0.2961460446247465,0.511,"[{'tx': 12, 'success': 4, 'collisions': 8}, {'tx': 18, 'success': 5, 'collisions': 13}, {'tx': 24, 'success': 10, 'collisions': 14}, {'tx': 12, 'success': 4, 'collisions': 8}, {'tx': 6, 'success': 0, 'collisions': 6}, {'tx': 19, 'success': 9, 'collisions': 10}, {'tx': 12, 'success': 2, 'collisions': 10}, {'tx': 8, 'success': 1, 'collisions': 7}, {'tx': 7, 'success': 1, 'collisions': 6}, {'tx': 9, 'success': 2, 'collisions': 7}, {'tx': 7, 'success': 0, 'collisions': 7}, {'tx': 8, 'success': 1, 'collisions': 7}, {'tx': 6, 'success': 0, 'collisions': 6}, {'tx': 5, 'success': 0, 'collisions': 5}, {'tx': 11, 'success': 3, 'collisions': 8}, {'tx': 11, 'success': 2, 'collisions': 9}, {'tx': 10, 'success': 1, 'collisions': 9}, {'tx': 8, 'success': 1, 'collisions': 7}, {'tx': 5, 'success': 0, 'collisions': 5}, {'tx': 33, 'success': 20, 'collisions': 13}, {'tx': 8, 'success': 1, 'collisions': 7}, {'tx': 5, 'success': 0, 'collisions': 5}, {'tx': 6, 'success': 0, 'collisions': 6}, {'tx': 17, 'success': 6, 'collisions': 11}, {'tx': 6, 'success': 0, 'collisions': 6}, {'tx': 13, 'success': 3, 'collisions': 10}, {'tx': 18, 'success': 5, 'collisions': 13}, {'tx': 25, 'success': 9, 'collisions': 16}, {'tx': 20, 'success': 7, 'collisions': 13}, {'tx': 18, 'success': 7, 'collisions': 11}, {'tx': 15, 'success': 5, 'collisions': 10}, {'tx': 5, 'success': 0, 'collisions': 5}, {'tx': 17, 'success': 5, 'collisions': 12}, {'tx': 6, 'success': 1, 'collisions': 5}, {'tx': 14, 'success': 5, 'collisions': 9}, {'tx': 30, 'success': 17, 'collisions': 13}, {'tx': 5, 'success': 0, 'collisions': 5}, {'tx': 10, 'success': 3, 'collisions': 7}, {'tx': 10, 'success': 2, 'collisions': 8}, {'tx': 14, 'success': 4, 'collisions': 10}]"
235,40,36,486,139,347,0.7139917695473251,0.28600823045267487,0.5004,"[{'tx': 5, 'success': 0, 'collisions': 5}, {'tx': 16, 'success': 6, 'collisions': 10}, {'tx': 10, 'success': 3, 'collisions': 7}, {'tx': 15, 'success': 5, 'collisions': 10}, {'tx': 12, 'success': 4, 'collisions': 8}, {'tx': 16, 'success': 4, 'collisions': 12}, {'tx': 13, 'success': 2, 'collisions': 11}, {'tx': 11, 'success': 2, 'collisions': 9}, {'tx': 5, 'success': 0, 'collisions': 5}, {'tx': 7, 'success': 0, 'collisions': 7}, {'tx': 12, 'success': 4, 'collisions': 8}, {'tx': 6, 'success': 1, 'collisions': 5}, {'tx': 17, 'success': 6, 'collisions': 11}, {'tx': 6, 'success': 0, 'collisions': 6}, {'tx': 15, 'success': 4, 'collisions': 11}, {'tx': 17, 'success': 4, 'collisions': 13}, {'tx': 14, 'success': 6, 'collisions': 8}, {'tx': 12, 'success': 6, 'collisions': 6}, {'tx': 15, 'success': 4, 'collisions': 11}, {'tx': 8, 'success': 1, 'collisions': 7}, {'tx': 6, 'success': 1, 'collisions': 5}, {'tx': 11, 'success': 4, 'collisions': 7}, {'tx': 12, 'success': 3, 'collisions': 9}, {'tx': 8, 'success': 1, 'collisions': 7}, {'tx': 14, 'success': 3, 'collisions': 11}, {'tx': 7, 'success': 1, 'collisions': 6}, {'tx': 16, 'success': 4, 'collisions': 12}, {'tx': 9, 'success': 1, 'collisions': 8}, {'tx': 24, 'success': 10, 'collisions': 14}, {'tx': 19, 'success': 8, 'collisions': 11}, {'tx': 19, 'success': 6, 'collisions': 13}, {'tx': 13, 'success': 4, 'collisions': 9}, {'tx': 29, 'success': 14, 'collisions': 15}, {'tx': 5, 'success': 1, 'collisions': 4}, {'tx': 12, 'success': 4, 'collisions': 8}, {'tx': 16, 'success': 5, 'collisions': 11}, {'tx': 5, 'success': 0, 'collisions': 5}, {'tx': 5, 'success': 0, 'collisions': 5}, {'tx': 6, 'success': 1, 'collisions': 5}, {'tx': 18, 'success': 6, 'collisions': 12}]"
236,40,37,461,146,315,0.6832971800433839,0.31670281995661603,0.5402,"[{'tx': 5, 'success': 0, 'collisions': 5}, {'tx': 14, 'success': 6, 'collisions': 8}, {'tx': 14, 'success': 5, 'collisions': 9}, {'tx': 11, 'success': 4, 'collisions': 7}, {'tx': 5, 'success': 0, 'collisions': 5}, {'tx': 21, 'success': 9, 'collisions': 12}, {'tx': 12, 'success': 6, 'collisions': 6}, {'tx': 14, 'success': 3, 'collisions': 11}, {'tx': 5, 'success': 0, 'collisions': 5}, {'tx': 27, 'success': 14, 'collisions': 13}, {'tx': 20, 'success': 8, 'collisions': 12}, {'tx': 8, 'success': 1, 'collisions': 7}, {'tx': 6, 'success': 1, 'collisions': 5}, {'tx': 9, 'success': 3, 'collisions': 6}, {'tx': 10, 'success': 1, 'collisions': 9}, {'tx': 17, 'success': 5, 'collisions': 12}, {'tx': 12, 'success': 4, 'collisions': 8}, {'tx': 5, 'success': 0, 'collisions': 5}, {'tx': 16, 'success': 7, 'collisions': 9}, {'tx': 10, 'success': 2, 'collisions': 8}, {'tx': 5, 'success': 0, 'collisions': 5}, {'tx': 6, 'success': 1, 'collisions': 5}, {'tx': 9, 'success': 1, 'collisions': 8}, {'tx': 15, 'success': 5, 'collisions': 10}, {'tx': 5, 'success': 0, 'collisions': 5}, {'tx': 14, 'success': 6, 'collisions': 8}, {'tx': 7, 'success': 1, 'collisions': 6}, {'tx': 6, 'success': 0, 'collisions': 6}, {'tx': 18, 'success': 8, 'collisions': 10}, {'tx': 13, 'success': 6, 'collisions': 7}, {'tx': 19, 'success': 8, 'collisions': 11}, {'tx': 7, 'success': 1, 'collisions': 6}, {'tx': 4, 'success': 0, 'collisions': 4}, {'tx': 5, 'success': 0, 'collisions': 5}, {'tx': 11, 'success': 2, 'collisions': 9}, {'tx': 23, 'success': 9, 'collisions': 14}, {'tx': 9, 'success': 2, 'collisions': 7}, {'tx': 22, 'success': 11, 'collisions': 11}, {'tx': 11, 'success': 3, 'collisions': 8}, {'tx': 11, 'success': 3, 'collisions': 8}]"
237,40,38,443,139,304,0.6862302483069977,0.31376975169300225,0.5282,"[{'tx': 6, 'success': 0, 'collisions': 6}, {'tx': 25, 'success': 15, 'collisions': 10}, {'tx': 5, 'success': 0, 'collisions': 5}, {'tx': 11, 'success': 4, 'collisions': 7}, {'tx': 6, 'success': 1, 'collisions': 5}, {'tx': 15, 'success': 5, 'collisions': 10}, {'tx': 5, 'success': 0, 'collisions': 5}, {'tx': 8, 'success': 1, 'collisions': 7}, {'tx': 21, 'success': 10, 'collisions': 11}, {'tx': 5, 'success': 0, 'collisions': 5}, {'tx': 5, 'success': 0, 'collisions': 5}, {'tx': 5, 'success': 0, 'collisions': 5}, {'tx': 5, 'success': 0, 'collisions': 5}, {'tx': 13, 'success': 4, 'collisions': 9}, {'tx': 7, 'success': 0, 'collisions': 7}, {'tx': 4, 'success': 0, 'collisions': 4}, {'tx': 4, 'success': 0, 'collisions': 4}, {'tx': 24, 'success': 10, 'collisions': 14}, {'tx': 13, 'success': 5, 'collisions': 8}, {'tx': 5, 'success': 0, 'collisions': 5}, {'tx': 17, 'success': 7, 'collisions': 10}, {'tx': 16, 'success': 6, 'collisions': 10}, {'tx': 13, 'success': 5, 'collisions': 8}, {'tx': 12, 'success': 4, 'collisions': 8}, {'tx': 9, 'success': 2, 'collisions': 7}, {'tx': 13, 'success': 3, 'collisions': 10}, {'tx': 5, 'success': 0, 'collisions': 5}, {'tx': 14, 'success': 3, 'collisions': 11}, {'tx': 21, 'success': 9, 'collisions': 12}, {'tx': 6, 'success': 0, 'collisions': 6}, {'tx': 12, 'success': 3, 'collisions': 9}, {'tx': 5, 'success': 0, 'collisions': 5}, {'tx': 15, 'success': 6, 'collisions': 9}, {'tx': 25, 'success': 14, 'collisions': 11}, {'tx': 15, 'success': 6, 'collisions': 9}, {'tx': 17, 'success': 6, 'collisions': 11}, {'tx': 8, 'success': 2, 'collisions': 6}, {'tx': 8, 'success': 2, 'collisions': 6}, {'tx': 15, 'success': 6, 'collisions': 9}, {'tx': 5, 'success': 0, 'collisions': 5}]"
238,40,39,444,132,312,0.7027027027027027,0.2972972972972973,0.5148,"[{'tx': 9, 'success': 2, 'collisions': 7}, {'tx': 18, 'success': 8, 'collisions': 10}, {'tx': 17, 'success': 7, 'collisions': 10}, {'tx': 12, 'success': 3, 'collisions': 9}, {'tx': 20, 'success': 8, 'collisions': 12}, {'tx': 17, 'success': 6, 'collisions': 11}, {'tx': 14, 'success': 5, 'collisions': 9}, {'tx': 5, 'success': 0, 'collisions': 5}, {'tx': 8, 'success': 1, 'collisions': 7}, {'tx': 10, 'success': 2, 'collisions': 8}, {'tx': 19, 'success': 6, 'collisions': 13}, {'tx': 10, 'success': 2, 'collisions': 8}, {'tx': 10, 'success': 3, 'collisions': 7}, {'tx': 8, 'success': 2, 'collisions': 6}, {'tx': 5, 'success': 0, 'collisions': 5}, {'tx': 4, 'success': 0, 'collisions': 4}, {'tx': 6, 'success': 0, 'collisions': 6}, {'tx': 20, 'success': 8, 'collisions': 12}, {'tx': 11, 'success': 3, 'collisions': 8}, {'tx': 5, 'success': 1, 'collisions': 4}, {'tx': 16, 'success': 6, 'collisions': 10}, {'tx': 12, 'success': 4, 'collisions': 8}, {'tx': 5, 'success': 0, 'collisions': 5}, {'tx': 15, 'success': 7, 'collisions': 8}, {'tx': 16, 'success': 4, 'collisions': 12}, {'tx': 10, 'success': 3, 'collisions': 7}, {'tx': 15, 'success': 7, 'collisions': 8}, {'tx': 11, 'success': 3, 'collisions': 8}, {'tx': 15, 'success': 5, 'collisions': 10}, {'tx': 17, 'success': 8, 'collisions': 9}, {'tx': 4, 'success': 0, 'collisions': 4}, {'tx': 5, 'success': 0, 'collisions': 5}, {'tx': 13, 'success': 6, 'collisions': 7}, {'tx': 5, 'success': 0, 'collisions': 5}, {'tx': 5, 'success': 0, 'collisions': 5}, {'tx': 5, 'success': 0, 'collisions': 5}, {'tx': 18, 'success': 6, 'collisions': 12}, {'tx': 9, 'success': 1, 'collisions': 8}, {'tx': 5, 'success': 0, 'collisions': 5}, {'tx': 15, 'success': 5, 'collisions': 10}]"
239,40,40,438,129,309,0.7054794520547946,0.2945205479452055,0.516,"[{'tx': 16, 'success': 6, 'collisions': 10}, {'tx': 9, 'success': 1, 'collisions': 8}, {'tx': 5, 'success': 0, 'collisions': 5}, {'tx': 8, 'success': 1, 'collisions': 7}, {'tx': 5, 'success': 0, 'collisions': 5}, {'tx': 5, 'success': 0, 'collisions': 5}, {'tx': 10, 'success': 2, 'collisions': 8}, {'tx': 7, 'success': 1, 'collisions': 6}, {'tx': 19, 'success': 5, 'collisions': 14}, {'tx': 19, 'success': 8, 'collisions': 11}, {'tx': 10, 'success': 2, 'collisions': 8}, {'tx': 8, 'success': 1, 'collisions': 7}, {'tx': 10, 'success': 1, 'collisions': 9}, {'tx': 10, 'success': 5, 'collisions': 5}, {'tx': 12, 'success': 3, 'collisions': 9}, {'tx': 11, 'success': 2, 'collisions': 9}, {'tx': 4, 'success': 0, 'collisions': 4}, {'tx': 8, 'success': 1, 'collisions': 7}, {'tx': 10, 'success': 2, 'collisions': 8}, {'tx': 8, 'success': 1, 'collisions': 7}, {'tx': 16, 'success': 6, 'collisions': 10}, {'tx': 16, 'success': 6, 'collisions': 10}, {'tx': 5, 'success': 0, 'collisions': 5}, {'tx': 5, 'success': 0, 'collisions': 5}, {'tx': 21, 'success': 14, 'collisions': 7}, {'tx': 12, 'success': 2, 'collisions': 10}, {'tx': 15, 'success': 5, 'collisions': 10}, {'tx': 8, 'success': 1, 'collisions': 7}, {'tx': 5, 'success': 0, 'collisions': 5}, {'tx': 26, 'success': 17, 'collisions': 9}, {'tx': 18, 'success': 7, 'collisions': 11}, {'tx': 4, 'success': 0, 'collisions': 4}, {'tx': 13, 'success': 5, 'collisions': 8}, {'tx': 7, 'success': 1, 'collisions': 6}, {'tx': 20, 'success': 8, 'collisions': 12}, {'tx': 11, 'success': 3, 'collisions': 8}, {'tx': 6, 'success': 1, 'collisions': 5}, {'tx': 11, 'success': 4, 'collisions': 7}, {'tx': 11, 'success': 3, 'collisions': 8}, {'tx': 14, 'success': 4, 'collisions': 10}]"
240,40,41,419,131,288,0.6873508353221957,0.3126491646778043,0.5371,"[{'tx': 13, 'success': 3, 'collisions': 10}, {'tx': 4, 'success': 0, 'collisions': 4}, {'tx': 7, 'success': 2, 'collisions': 5}, {'tx': 9, 'success': 3, 'collisions': 6}, {'tx': 11, 'success': 3, 'collisions': 8}, {'tx': 9, 'success': 2, 'collisions': 7}, {'tx': 18, 'success': 8, 'collisions': 10}, {'tx': 24, 'success': 13, 'collisions': 11}, {'tx': 11, 'success': 3, 'collisions': 8}, {'tx': 5, 'success': 0, 'collisions': 5}, {'tx': 4, 'success': 0, 'collisions': 4}, {'tx': 15, 'success': 6, 'collisions': 9}, {'tx': 11, 'success': 2, 'collisions': 9}, {'tx': 5, 'success': 0, 'collisions': 5}, {'tx': 5, 'success': 0, 'collisions': 5}, {'tx': 12, 'success': 5, 'collisions': 7}, {'tx': 4, 'success': 0, 'collisions': 4}, {'tx': 9, 'success': 3, 'collisions': 6}, {'tx': 8, 'success': 2, 'collisions': 6}, {'tx': 19, 'success': 7, 'collisions': 12}, {'tx': 6, 'success': 0, 'collisions': 6}, {'tx': 7, 'success': 1, 'collisions': 6}, {'tx': 21, 'success': 10, 'collisions': 11}, {'tx': 4, 'success': 0, 'collisions': 4}, {'tx': 13, 'success': 4, 'collisions': 9}, {'tx': 5, 'success': 0, 'collisions': 5}, {'tx': 5, 'success': 0, 'collisions': 5}, {'tx': 16, 'success': 7, 'collisions': 9}, {'tx': 5, 'success': 0, 'collisions': 5}, {'tx': 10, 'success': 3, 'collisions': 7}, {'tx': 22, 'success': 12, 'collisions': 10}, {'tx': 10, 'success': 2, 'collisions': 8}, {'tx': 15, 'success': 7, 'collisions': 8}, {'tx': 14, 'success': 4, 'collisions': 10}, {'tx': 6, 'success': 1, 'collisions': 5}, {'tx': 11, 'success': 3, 'collisions': 8}, {'tx': 10, 'success': 3, 'collisions': 7}, {'tx': 7, 'success': 1, 'collisions': 6}, {'tx': 21, 'success': 10, 'collisions': 11}, {'tx': 8, 'success': 1, 'collisions': 7}]"
241,40,42,420,119,301,0.7166666666666667,0.2833333333333333,0.4998,"[{'tx': 8, 'success': 3, 'collisions': 5}, {'tx': 12, 'success': 3, 'collisions': 9}, {'tx': 5, 'success': 0, 'collisions': 5}, {'tx': 5, 'success': 0, 'collisions': 5}, {'tx': 11, 'success': 3, 'collisions': 8}, {'tx': 6, 'success': 1, 'collisions': 5}, {'tx': 14, 'success': 4, 'collisions': 10}, {'tx': 14, 'success': 4, 'collisions': 10}, {'tx': 8, 'success': 1, 'collisions': 7}, {'tx': 5, 'success': 0, 'collisions': 5}, {'tx': 16, 'success': 7, 'collisions': 9}, {'tx': 20, 'success': 9, 'collisions': 11}, {'tx': 8, 'success': 3, 'collisions': 5}, {'tx': 9, 'success': 2, 'collisions': 7}, {'tx': 5, 'success': 0, 'collisions': 5}, {'tx': 9, 'success': 2, 'collisions': 7}, {'tx': 6, 'success': 0, 'collisions': 6}, {'tx': 13, 'success': 4, 'collisions': 9}, {'tx': 13, 'success': 3, 'collisions': 10}, {'tx': 9, 'success': 2, 'collisions': 7}, {'tx': 5, 'success': 0, 'collisions': 5}, {'tx': 28, 'success': 15, 'collisions': 13}, {'tx': 8, 'success': 1, 'collisions': 7}, {'tx': 6, 'success': 0, 'collisions': 6}, {'tx': 19, 'success': 8, 'collisions': 11}, {'tx': 6, 'success': 1, 'collisions': 5}, {'tx': 6, 'success': 0, 'collisions': 6}, {'tx': 22, 'success': 10, 'collisions': 12}, {'tx': 8, 'success': 1, 'collisions': 7}, {'tx': 10, 'success': 2, 'collisions': 8}, {'tx': 15, 'success': 4, 'collisions': 11}, {'tx': 18, 'success': 6, 'collisions': 12}, {'tx': 14, 'success': 6, 'collisions': 8}, {'tx': 11, 'success': 3, 'collisions': 8}, {'tx': 5, 'success': 0, 'collisions': 5}, {'tx': 5, 'success': 0, 'collisions': 5}, {'tx': 6, 'success': 1, 'collisions': 5}, {'tx': 14, 'success': 5, 'collisions': 9}, {'tx': 13, 'success': 5, 'collisions': 8}, {'tx': 5, 'success': 0, 'collisions': 5}]"
242,40,43,412,122,290,0.7038834951456311,0.2961165048543689,0.5246,"[{'tx': 9, 'success': 1, 'collisions': 8}, {'tx': 17, 'success': 6, 'collisions': 11}, {'tx': 16, 'success': 6, 'collisions': 10}, {'tx': 7, 'success': 1, 'collisions': 6}, {'tx': 8, 'success': 2, 'collisions': 6}, {'tx': 5, 'success': 0, 'collisions': 5}, {'tx': 5, 'success': 0, 'collisions': 5}, {'tx': 14, 'success': 7, 'collisions': 7}, {'tx': 19, 'success': 10, 'collisions': 9}, {'tx': 21, 'success': 8, 'collisions': 13}, {'tx': 5, 'success': 0, 'collisions': 5}, {'tx': 8, 'success': 1, 'collisions': 7}, {'tx': 5, 'success': 0, 'collisions': 5}, {'tx': 6, 'success': 0, 'collisions': 6}, {'tx': 5, 'success': 0, 'collisions': 5}, {'tx': 6, 'success': 0, 'collisions': 6}, {'tx': 11, 'success': 3, 'collisions': 8}, {'tx': 8, 'success': 2, 'collisions': 6}, {'tx': 7, 'success': 1, 'collisions': 6}, {'tx': 12, 'success': 5, 'collisions': 7}, {'tx': 9, 'success': 2, 'collisions': 7}, {'tx': 18, 'success': 9, 'collisions': 9}, {'tx': 7, 'success': 1, 'collisions': 6}, {'tx': 9, 'success': 2, 'collisions': 7}, {'tx': 4, 'success': 0, 'collisions': 4}, {'tx': 5, 'success': 0, 'collisions': 5}, {'tx': 7, 'success': 1, 'collisions': 6}, {'tx': 17, 'success': 6, 'collisions': 11}, {'tx': 13, 'success': 5, 'collisions': 8}, {'tx': 10, 'success': 2, 'collisions': 8}, {'tx': 14, 'success': 5, 'collisions': 9}, {'tx': 11, 'success': 4, 'collisions': 7}, {'tx': 17, 'success': 7, 'collisions': 10}, {'tx': 25, 'success': 11, 'collisions': 14}, {'tx': 5, 'success': 0, 'collisions': 5}, {'tx': 4, 'success': 0, 'collisions': 4}, {'tx': 5, 'success': 0, 'collisions': 5}, {'tx': 24, 'success': 11, 'collisions': 13}, {'tx': 5, 'success': 1, 'collisions': 4}, {'tx': 9, 'success': 2, 'collisions': 7}]"
243,40,44,407,119,288,0.7076167076167076,0.29238329238329236,0.5236,"[{'tx': 15, 'success': 5, 'collisions': 10}, {'tx': 6, 'success': 0, 'collisions': 6}, {'tx': 13, 'success': 4, 'collisions': 9}, {'tx': 21, 'success': 12, 'collisions': 9}, {'tx': 9, 'success': 3, 'collisions': 6}, {'tx': 9, 'success': 1, 'collisions': 8}, {'tx': 15, 'success': 6, 'collisions': 9}, {'tx': 5, 'success': 0, 'collisions': 5}, {'tx': 11, 'success': 2, 'collisions': 9}, {'tx': 21, 'success': 9, 'collisions': 12}, {'tx': 11, 'success': 4, 'collisions': 7}, {'tx': 18, 'success': 9, 'collisions': 9}, {'tx': 9, 'success': 2, 'collisions': 7}, {'tx': 4, 'success': 0, 'collisions': 4}, {'tx': 5, 'success': 0, 'collisions': 5}, {'tx': 8, 'success': 1, 'collisions': 7}, {'tx': 11, 'success': 3, 'collisions': 8}, {'tx': 12, 'success': 6, 'collisions': 6}, {'tx': 11, 'success': 4, 'collisions': 7}, {'tx': 10, 'success': 3, 'collisions': 7}, {'tx': 23, 'success': 10, 'collisions': 13}, {'tx': 15, 'success': 6, 'collisions': 9}, {'tx': 7, 'success': 1, 'collisions': 6}, {'tx': 5, 'success': 0, 'collisions': 5}, {'tx': 19, 'success': 6, 'collisions': 13}, {'tx': 4, 'success': 0, 'collisions': 4}, {'tx': 9, 'success': 3, 'collisions': 6}, {'tx': 13, 'success': 4, 'collisions': 9}, {'tx': 13, 'success': 4, 'collisions': 9}, {'tx': 4, 'success': 0, 'collisions': 4}, {'tx': 8, 'success': 1, 'collisions': 7}, {'tx': 5, 'success': 0, 'collisions': 5}, {'tx': 4, 'success': 0, 'collisions': 4}, {'tx': 4, 'success': 0, 'collisions': 4}, {'tx': 5, 'success': 0, 'collisions': 5}, {'tx': 10, 'success': 3, 'collisions': 7}, {'tx': 12, 'success': 3, 'collisions': 9}, {'tx': 5, 'success': 0, 'collisions': 5}, {'tx': 14, 'success': 4, 'collisions': 10}, {'tx': 4, 'success': 0, 'collisions': 4}]"
244,40,45,396,115,281,0.7095959595959596,0.2904040404040404,0.5175,"[{'tx': 12, 'success': 3, 'collisions': 9}, {'tx': 10, 'success': 2, 'collisions': 8}, {'tx': 15, 'success': 5, 'collisions': 10}, {'tx': 6, 'success': 1, 'collisions': 5}, {'tx': 9, 'success': 4, 'collisions': 5}, {'tx': 5, 'success': 0, 'collisions': 5}, {'tx': 5, 'success': 0, 'collisions': 5}, {'tx': 13, 'success': 4, 'collisions': 9}, {'tx': 11, 'success': 3, 'collisions': 8}, {'tx': 5, 'success': 0, 'collisions': 5}, {'tx': 11, 'success': 3, 'collisions': 8}, {'tx': 4, 'success': 0, 'collisions': 4}, {'tx': 23, 'success': 12, 'collisions': 11}, {'tx': 7, 'success': 1, 'collisions': 6}, {'tx': 6, 'success': 0, 'collisions': 6}, {'tx': 6, 'success': 1, 'collisions': 5}, {'tx': 5, 'success': 0, 'collisions': 5}, {'tx': 18, 'success': 7, 'collisions': 11}, {'tx': 15, 'success': 4, 'collisions': 11}, {'tx': 20, 'success': 8, 'collisions': 12}, {'tx': 5, 'success': 0, 'collisions': 5}, {'tx': 5, 'success': 0, 'collisions': 5}, {'tx': 12, 'success': 6, 'collisions': 6}, {'tx': 8, 'success': 2, 'collisions': 6}, {'tx': 5, 'success': 0, 'collisions': 5}, {'tx': 12, 'success': 4, 'collisions': 8}, {'tx': 18, 'success': 7, 'collisions': 11}, {'tx': 14, 'success': 5, 'collisions': 9}, {'tx': 5, 'success': 0, 'collisions': 5}, {'tx': 14, 'success': 7, 'collisions': 7}, {'tx': 12, 'success': 4, 'collisions': 8}, {'tx': 13, 'success': 4, 'collisions': 9}, {'tx': 5, 'success': 0, 'collisions': 5}, {'tx': 13, 'success': 4, 'collisions': 9}, {'tx': 11, 'success': 4, 'collisions': 7}, {'tx': 5, 'success': 0, 'collisions': 5}, {'tx': 5, 'success': 0, 'collisions': 5}, {'tx': 7, 'success': 2, 'collisions': 5}, {'tx': 6, 'success': 2, 'collisions': 4}, {'tx': 15, 'success': 6, 'collisions': 9}]"
245,40,46,384,113,271,0.7057291666666666,0.2942708333333333,0.5198,"[{'tx': 17, 'success': 8, 'collisions': 9}, {'tx': 6, 'success': 0, 'collisions': 6}, {'tx': 7, 'success': 2, 'collisions': 5}, {'tx': 5, 'success': 0, 'collisions': 5}, {'tx': 10, 'success': 2, 'collisions': 8}, {'tx': 9, 'success': 2, 'collisions': 7}, {'tx': 4, 'success': 0, 'collisions': 4}, {'tx': 4, 'success': 0, 'collisions': 4}, {'tx': 5, 'success': 0, 'collisions': 5}, {'tx': 24, 'success': 12, 'collisions': 12}, {'tx': 13, 'success': 5, 'collisions': 8}, {'tx': 7, 'success': 2, 'collisions': 5}, {'tx': 8, 'success': 1, 'collisions': 7}, {'tx': 17, 'success': 6, 'collisions': 11}, {'tx': 4, 'success': 0, 'collisions': 4}, {'tx': 11, 'success': 3, 'collisions': 8}, {'tx': 12, 'success': 3, 'collisions': 9}, {'tx': 6, 'success': 1, 'collisions': 5}, {'tx': 17, 'success': 7, 'collisions': 10}, {'tx': 12, 'success': 3, 'collisions': 9}, {'tx': 6, 'success': 0, 'collisions': 6}, {'tx': 10, 'success': 2, 'collisions': 8}, {'tx': 12, 'success': 3, 'collisions': 9}, {'tx': 13, 'success': 4, 'collisions': 9}, {'tx': 14, 'success': 5, 'collisions': 9}, {'tx': 5, 'success': 0, 'collisions': 5}, {'tx': 5, 'success': 0, 'collisions': 5}, {'tx': 4, 'success': 0, 'collisions': 4}, {'tx': 18, 'success': 10, 'collisions': 8}, {'tx': 21, 'success': 12, 'collisions': 9}, {'tx': 6, 'success': 2, 'collisions': 4}, {'tx': 8, 'success': 2, 'collisions': 6}, {'tx': 13, 'success': 7, 'collisions': 6}, {'tx': 5, 'success': 0, 'collisions': 5}, {'tx': 5, 'success': 0, 'collisions': 5}, {'tx': 14, 'success': 5, 'collisions': 9}, {'tx': 13, 'success': 4, 'collisions': 9}, {'tx': 5, 'success': 0, 'collisions': 5}, {'tx': 4, 'success': 0, 'collisions': 4}, {'tx': 5, 'success': 0, 'collisions': 5}]"
246,40,47,375,107,268,0.7146666666666667,0.2853333333333333,0.5029,"[{'tx': 15, 'success': 7, 'collisions': 8}, {'tx': 10, 'success': 2, 'collisions': 8}, {'tx': 10, 'success': 2, 'collisions': 8}, {'tx': 13, 'success': 5, 'collisions': 8}, {'tx': 5, 'success': 0, 'collisions': 5}, {'tx': 7, 'success': 1, 'collisions': 6}, {'tx': 15, 'success': 6, 'collisions': 9}, {'tx': 7, 'success': 1, 'collisions': 6}, {'tx': 14, 'success': 6, 'collisions': 8}, {'tx': 5, 'success': 0, 'collisions': 5}, {'tx': 4, 'success': 0, 'collisions': 4}, {'tx': 4, 'success': 0, 'collisions': 4}, {'tx': 15, 'success': 7, 'collisions': 8}, {'tx': 6, 'success': 0, 'collisions': 6}, {'tx': 5, 'success': 0, 'collisions': 5}, {'tx': 4, 'success': 0, 'collisions': 4}, {'tx': 4, 'success': 0, 'collisions': 4}, {'tx': 14, 'success': 5, 'collisions': 9}, {'tx': 8, 'success': 2, 'collisions': 6}, {'tx': 17, 'success': 8, 'collisions': 9}, {'tx': 14, 'success': 5, 'collisions': 9}, {'tx': 21, 'success': 8, 'collisions': 13}, {'tx': 7, 'success': 1, 'collisions': 6}, {'tx': 5, 'success': 0, 'collisions': 5}, {'tx': 12, 'success': 3, 'collisions': 9}, {'tx': 6, 'success': 1, 'collisions': 5}, {'tx': 5, 'success': 0, 'collisions': 5}, {'tx': 5, 'success': 0, 'collisions': 5}, {'tx': 15, 'success': 7, 'collisions': 8}, {'tx': 7, 'success': 1, 'collisions': 6}, {'tx': 8, 'success': 2, 'collisions': 6}, {'tx': 13, 'success': 5, 'collisions': 8}, {'tx': 10, 'success': 3, 'collisions': 7}, {'tx': 5, 'success': 0, 'collisions': 5}, {'tx': 5, 'success': 0, 'collisions': 5}, {'tx': 15, 'success': 8, 'collisions': 7}, {'tx': 4, 'success': 0, 'collisions': 4}, {'tx': 14, 'success': 5, 'collisions': 9}, {'tx': 15, 'success': 5, 'collisions': 10}, {'tx': 7, 'success': 1, 'collisions': 6}]"
247,40,48,375,110,265,0.7066666666666667,0.29333333333333333,0.528,"[{'tx': 13, 'success': 6, 'collisions': 7}, {'tx': 20, 'success': 11, 'collisions': 9}, {'tx': 8, 'success': 1, 'collisions': 7}, {'tx': 11, 'success': 2, 'collisions': 9}, {'tx': 4, 'success': 0, 'collisions': 4}, {'tx': 14, 'success': 7, 'collisions': 7}, {'tx': 4, 'success': 0, 'collisions': 4}, {'tx': 16, 'success': 6, 'collisions': 10}, {'tx': 11, 'success': 3, 'collisions': 8}, {'tx': 14, 'success': 6, 'collisions': 8}, {'tx': 10, 'success': 3, 'collisions': 7}, {'tx': 4, 'success': 0, 'collisions': 4}, {'tx': 10, 'success': 3, 'collisions': 7}, {'tx': 8, 'success': 2, 'collisions': 6}, {'tx': 12, 'success': 5, 'collisions': 7}, {'tx': 4, 'success': 0, 'collisions': 4}, {'tx': 7, 'success': 1, 'collisions': 6}, {'tx': 6, 'success': 2, 'collisions': 4}, {'tx': 13, 'success': 7, 'collisions': 6}, {'tx': 13, 'success': 4, 'collisions': 9}, {'tx': 9, 'success': 2, 'collisions': 7}, {'tx': 5, 'success': 0, 'collisions': 5}, {'tx': 10, 'success': 2, 'collisions': 8}, {'tx': 12, 'success': 3, 'collisions': 9}, {'tx': 5, 'success': 0, 'collisions': 5}, {'tx': 4, 'success': 0, 'collisions': 4}, {'tx': 11, 'success': 2, 'collisions': 9}, {'tx': 4, 'success': 0, 'collisions': 4}, {'tx': 4, 'success': 0, 'collisions': 4}, {'tx': 8, 'success': 2, 'collisions': 6}, {'tx': 8, 'success': 2, 'collisions': 6}, {'tx': 4, 'success': 0, 'collisions': 4}, {'tx': 7, 'success': 1, 'collisions': 6}, {'tx': 15, 'success': 6, 'collisions': 9}, {'tx': 17, 'success': 8, 'collisions': 9}, {'tx': 4, 'success': 0, 'collisions': 4}, {'tx': 14, 'success': 6, 'collisions': 8}, {'tx': 9, 'success': 1, 'collisions': 8}, {'tx': 13, 'success': 3, 'collisions': 10}, {'tx': 10, 'success': 3, 'collisions': 7}]"
248,40,49,364,106,258,0.7087912087912088,0.29120879120879123,0.5194,"[{'tx': 4, 'success': 0, 'collisions': 4}, {'tx': 7, 'success': 1, 'collisions': 6}, {'tx': 4, 'success': 0, 'collisions': 4}, {'tx': 8, 'success': 2, 'collisions': 6}, {'tx': 11, 'success': 3, 'collisions': 8}, {'tx': 10, 'success': 3, 'collisions': 7}, {'tx': 16, 'success': 9, 'collisions': 7}, {'tx': 7, 'success': 1, 'collisions': 6}, {'tx': 6, 'success': 1, 'collisions': 5}, {'tx': 13, 'success': 6, 'collisions': 7}, {'tx': 16, 'success': 6, 'collisions': 10}, {'tx': 4, 'success': 0, 'collisions': 4}, {'tx': 10, 'success': 3, 'collisions': 7}, {'tx': 5, 'success': 0, 'collisions': 5}, {'tx': 10, 'success': 3, 'collisions': 7}, {'tx': 14, 'success': 7, 'collisions': 7}, {'tx': 4, 'success': 0, 'collisions': 4}, {'tx': 13, 'success': 5, 'collisions': 8}, {'tx': 7, 'success': 1, 'collisions': 6}, {'tx': 12, 'success': 5, 'collisions': 7}, {'tx': 6, 'success': 0, 'collisions': 6}, {'tx': 11, 'success': 5, 'collisions': 6}, {'tx': 14, 'success': 6, 'collisions': 8}, {'tx': 15, 'success': 5, 'collisions': 10}, {'tx': 6, 'success': 0, 'collisions': 6}, {'tx': 4, 'success': 0, 'collisions': 4}, {'tx': 8, 'success': 1, 'collisions': 7}, {'tx': 12, 'success': 5, 'collisions': 7}, {'tx': 11, 'success': 4, 'collisions': 7}, {'tx': 5, 'success': 0, 'collisions': 5}, {'tx': 25, 'success': 13, 'collisions': 12}, {'tx': 8, 'success': 1, 'collisions': 7}, {'tx': 4, 'success': 0, 'collisions': 4}, {'tx': 12, 'success': 3, 'collisions': 9}, {'tx': 7, 'success': 1, 'collisions': 6}, {'tx': 5, 'success': 0, 'collisions': 5}, {'tx': 6, 'success': 1, 'collisions': 5}, {'tx': 8, 'success': 1, 'collisions': 7}, {'tx': 6, 'success': 1, 'collisions': 5}, {'tx': 10, 'success': 3, 'collisions': 7}]"
249,40,50,375,100,275,0.7333333333333333,0.26666666666666666,0.5,"[{'tx': 5, 'success': 0, 'collisions': 5}, {'tx': 11, 'success': 5, 'collisions': 6}, {'tx': 10, 'success': 3, 'collisions': 7}, {'tx': 7, 'success': 1, 'collisions': 6}, {'tx': 12, 'success': 4, 'collisions': 8}, {'tx': 8, 'success': 1, 'collisions': 7}, {'tx': 5, 'success': 0, 'collisions': 5}, {'tx': 7, 'success': 1, 'collisions': 6}, {'tx': 10, 'success': 2, 'collisions': 8}, {'tx': 5, 'success': 0, 'collisions': 5}, {'tx': 11, 'success': 3, 'collisions': 8}, {'tx': 5, 'success': 0, 'collisions': 5}, {'tx': 7, 'success': 1, 'collisions': 6}, {'tx': 16, 'success': 3, 'collisions': 13}, {'tx': 16, 'success': 7, 'collisions': 9}, {'tx': 5, 'success': 0, 'collisions': 5}, {'tx': 6, 'success': 1, 'collisions': 5}, {'tx': 10, 'success': 2, 'collisions': 8}, {'tx': 4, 'success': 0, 'collisions': 4}, {'tx': 11, 'success': 3, 'collisions': 8}, {'tx': 17, 'success': 9, 'collisions': 8}, {'tx': 4, 'success': 0, 'collisions': 4}, {'tx': 5, 'success': 0, 'collisions': 5}, {'tx': 4, 'success': 0, 'collisions': 4}, {'tx': 13, 'success': 5, 'collisions': 8}, {'tx': 18, 'success': 9, 'collisions': 9}, {'tx': 5, 'success': 0, 'collisions': 5}, {'tx': 8, 'success': 1, 'collisions': 7}, {'tx': 13, 'success': 5, 'collisions': 8}, {'tx': 9, 'success': 1, 'collisions': 8}, {'tx': 6, 'success': 0, 'collisions': 6}, {'tx': 19, 'success': 9, 'collisions': 10}, {'tx': 8, 'success': 1, 'collisions': 7}, {'tx': 9, 'success': 2, 'collisions': 7}, {'tx': 4, 'success': 0, 'collisions': 4}, {'tx': 12, 'success': 3, 'collisions': 9}, {'tx': 12, 'success': 3, 'collisions': 9}, {'tx': 18, 'success': 9, 'collisions': 9}, {'tx': 12, 'success': 4, 'collisions': 8}, {'tx': 8, 'success': 2, 'collisions': 6}]"
250,40,51,353,100,253,0.71671388101983,0.28328611898017,0.51,"[{'tx': 10, 'success': 3, 'collisions': 7}, {'tx': 15, 'success': 6, 'collisions': 9}, {'tx': 5, 'success': 1, 'collisions': 4}, {'tx': 4, 'success': 0, 'collisions': 4}, {'tx': 11, 'success': 5, 'collisions': 6}, {'tx': 4, 'success': 0, 'collisions': 4}, {'tx': 7, 'success': 1, 'collisions': 6}, {'tx': 4, 'success': 0, 'collisions': 4}, {'tx': 5, 'success': 0, 'collisions': 5}, {'tx': 9, 'success': 2, 'collisions': 7}, {'tx': 12, 'success': 5, 'collisions': 7}, {'tx': 4, 'success': 0, 'collisions': 4}, {'tx': 13, 'success': 4, 'collisions': 9}, {'tx': 5, 'success': 0, 'collisions': 5}, {'tx': 7, 'success': 3, 'collisions': 4}, {'tx': 16, 'success': 7, 'collisions': 9}, {'tx': 14, 'success': 6, 'collisions': 8}, {'tx': 13, 'success': 6, 'collisions': 7}, {'tx': 15, 'success': 5, 'collisions': 10}, {'tx': 13, 'success': 5, 'collisions': 8}, {'tx': 4, 'success': 0, 'collisions': 4}, {'tx': 5, 'success': 1, 'collisions': 4}, {'tx': 15, 'success': 5, 'collisions': 10}, {'tx': 9, 'success': 2, 'collisions': 7}, {'tx': 4, 'success': 0, 'collisions': 4}, {'tx': 13, 'success': 6, 'collisions': 7}, {'tx': 6, 'success': 1, 'collisions': 5}, {'tx': 10, 'success': 2, 'collisions': 8}, {'tx': 4, 'success': 0, 'collisions': 4}, {'tx': 7, 'success': 1, 'collisions': 6}, {'tx': 8, 'success': 1, 'collisions': 7}, {'tx': 4, 'success': 0, 'collisions': 4}, {'tx': 11, 'success': 3, 'collisions': 8}, {'tx': 11, 'success': 2, 'collisions': 9}, {'tx': 7, 'success': 1, 'collisions': 6}, {'tx': 13, 'success': 4, 'collisions': 9}, {'tx': 13, 'success': 3, 'collisions': 10}, {'tx': 14, 'success': 9, 'collisions': 5}, {'tx': 5, 'success': 0, 'collisions': 5}, {'tx': 4, 'success': 0, 'collisions': 4}]"
251,40,52,343,92,251,0.7317784256559767,0.26822157434402333,0.4784,"[{'tx': 14, 'success': 5, 'collisions': 9}, {'tx': 6, 'success': 0, 'collisions': 6}, {'tx': 4, 'success': 0, 'collisions': 4}, {'tx': 7, 'success': 1, 'collisions': 6}, {'tx': 4, 'success': 0, 'collisions': 4}, {'tx': 5, 'success': 0, 'collisions': 5}, {'tx': 5, 'success': 0, 'collisions': 5}, {'tx': 5, 'success': 0, 'collisions': 5}, {'tx': 5, 'success': 0, 'collisions': 5}, {'tx': 10, 'success': 2, 'collisions': 8}, {'tx': 9, 'success': 2, 'collisions': 7}, {'tx': 7, 'success': 1, 'collisions': 6}, {'tx': 11, 'success': 5, 'collisions': 6}, {'tx': 14, 'success': 4, 'collisions': 10}, {'tx': 10, 'success': 4, 'collisions': 6}, {'tx': 4, 'success': 0, 'collisions': 4}, {'tx': 14, 'success': 9, 'collisions': 5}, {'tx': 4, 'success': 0, 'collisions': 4}, {'tx': 12, 'success': 4, 'collisions': 8}, {'tx': 4, 'success': 0, 'collisions': 4}, {'tx': 6, 'success': 2, 'collisions': 4}, {'tx': 11, 'success': 4, 'collisions': 7}, {'tx': 7, 'success': 1, 'collisions': 6}, {'tx': 13, 'success': 7, 'collisions': 6}, {'tx': 7, 'success': 1, 'collisions': 6}, {'tx': 10, 'success': 2, 'collisions': 8}, {'tx': 9, 'success': 2, 'collisions': 7}, {'tx': 15, 'success': 6, 'collisions': 9}, {'tx': 4, 'success': 0, 'collisions': 4}, {'tx': 12, 'success': 4, 'collisions': 8}, {'tx': 7, 'success': 2, 'collisions': 5}, {'tx': 21, 'success': 11, 'collisions': 10}, {'tx': 9, 'success': 2, 'collisions': 7}, {'tx': 4, 'success': 0, 'collisions': 4}, {'tx': 9, 'success': 2, 'collisions': 7}, {'tx': 4, 'success': 0, 'collisions': 4}, {'tx': 10, 'success': 2, 'collisions': 8}, {'tx': 5, 'success': 0, 'collisions': 5}, {'tx': 13, 'success': 4, 'collisions': 9}, {'tx': 13, 'success': 3, 'collisions': 10}]"
252,40,53,349,91,258,0.7392550143266475,0.2607449856733524,0.4823,"[{'tx': 16, 'success': 7, 'collisions': 9}, {'tx': 10, 'success': 2, 'collisions': 8}, {'tx': 6, 'success': 1, 'collisions': 5}, {'tx': 8, 'success': 1, 'collisions': 7}, {'tx': 15, 'success': 8, 'collisions': 7}, {'tx': 7, 'success': 1, 'collisions': 6}, {'tx': 5, 'success': 0, 'collisions': 5}, {'tx': 5, 'success': 0, 'collisions': 5}, {'tx': 15, 'success': 6, 'collisions': 9}, {'tx': 4, 'success': 0, 'collisions': 4}, {'tx': 6, 'success': 1, 'collisions': 5}, {'tx': 14, 'success': 6, 'collisions': 8}, {'tx': 12, 'success': 5, 'collisions': 7}, {'tx': 6, 'success': 1, 'collisions': 5}, {'tx': 5, 'success': 0, 'collisions': 5}, {'tx': 9, 'success': 2, 'collisions': 7}, {'tx': 4, 'success': 0, 'collisions': 4}, {'tx': 13, 'success': 3, 'collisions': 10}, {'tx': 5, 'success': 0, 'collisions': 5}, {'tx': 7, 'success': 2, 'collisions': 5}, {'tx': 4, 'success': 0, 'collisions': 4}, {'tx': 5, 'success': 0, 'collisions': 5}, {'tx': 9, 'success': 1, 'collisions': 8}, {'tx': 8, 'success': 2, 'collisions': 6}, {'tx': 9, 'success': 2, 'collisions': 7}, {'tx': 12, 'success': 4, 'collisions': 8}, {'tx': 4, 'success': 0, 'collisions': 4}, {'tx': 14, 'success': 5, 'collisions': 9}, {'tx': 4, 'success': 0, 'collisions': 4}, {'tx': 11, 'success': 4, 'collisions': 7}, {'tx': 14, 'success': 6, 'collisions': 8}, {'tx': 12, 'success': 4, 'collisions': 8}, {'tx': 15, 'success': 5, 'collisions': 10}, {'tx': 4, 'success': 0, 'collisions': 4}, {'tx': 16, 'success': 7, 'collisions': 9}, {'tx': 7, 'success': 2, 'collisions': 5}, {'tx': 5, 'success': 0, 'collisions': 5}, {'tx': 12, 'success': 2, 'collisions': 10}, {'tx': 8, 'success': 1, 'collisions': 7}, {'tx': 4, 'success': 0, 'collisions': 4}]"
253,40,54,328,98,230,0.7012195121951219,0.29878048780487804,0.5292,"[{'tx': 8, 'success': 2, 'collisions': 6}, {'tx': 5, 'success': 1, 'collisions': 4}, {'tx': 15, 'success': 8, 'collisions': 7}, {'tx': 7, 'success': 2, 'collisions': 5}, {'tx': 4, 'success': 0, 'collisions': 4}, {'tx': 4, 'success': 0, 'collisions': 4}, {'tx': 8, 'success': 2, 'collisions': 6}, {'tx': 11, 'success': 4, 'collisions': 7}, {'tx': 5, 'success': 0, 'collisions': 5}, {'tx': 4, 'success': 0, 'collisions': 4}, {'tx': 4, 'success': 0, 'collisions': 4}, {'tx': 4, 'success': 0, 'collisions': 4}, {'tx': 13, 'success': 6, 'collisions': 7}, {'tx': 5, 'success': 0, 'collisions': 5}, {'tx': 13, 'success': 6, 'collisions': 7}, {'tx': 15, 'success': 7, 'collisions': 8}, {'tx': 4, 'success': 0, 'collisions': 4}, {'tx': 5, 'success': 0, 'collisions': 5}, {'tx': 4, 'success': 0, 'collisions': 4}, {'tx': 12, 'success': 6, 'collisions': 6}, {'tx': 7, 'success': 1, 'collisions': 6}, {'tx': 11, 'success': 3, 'collisions': 8}, {'tx': 15, 'success': 7, 'collisions': 8}, {'tx': 8, 'success': 2, 'collisions': 6}, {'tx': 14, 'success': 7, 'collisions': 7}, {'tx': 4, 'success': 0, 'collisions': 4}, {'tx': 4, 'success': 0, 'collisions': 4}, {'tx': 4, 'success': 0, 'collisions': 4}, {'tx': 13, 'success': 4, 'collisions': 9}, {'tx': 4, 'success': 0, 'collisions': 4}, {'tx': 5, 'success': 0, 'collisions': 5}, {'tx': 7, 'success': 1, 'collisions': 6}, {'tx': 6, 'success': 2, 'collisions': 4}, {'tx': 6, 'success': 1, 'collisions': 5}, {'tx': 11, 'success': 3, 'collisions': 8}, {'tx': 13, 'success': 6, 'collisions': 7}, {'tx': 12, 'success': 6, 'collisions': 6}, {'tx': 10, 'success': 3, 'collisions': 7}, {'tx': 20, 'success': 8, 'collisions': 12}, {'tx': 4, 'success': 0, 'collisions': 4}]"
254,40,55,331,92,239,0.7220543806646526,0.27794561933534745,0.506,"[{'tx': 16, 'success': 8, 'collisions': 8}, {'tx': 4, 'success': 0, 'collisions': 4}, {'tx': 8, 'success': 2, 'collisions': 6}, {'tx': 6, 'success': 1, 'collisions': 5}, {'tx': 4, 'success': 0, 'collisions': 4}, {'tx': 16, 'success': 8, 'collisions': 8}, {'tx': 10, 'success': 2, 'collisions': 8}, {'tx': 4, 'success': 0, 'collisions': 4}, {'tx': 5, 'success': 0, 'collisions': 5}, {'tx': 4, 'success': 0, 'collisions': 4}, {'tx': 4, 'success': 0, 'collisions': 4}, {'tx': 16, 'success': 8, 'collisions': 8}, {'tx': 7, 'success': 1, 'collisions': 6}, {'tx': 16, 'success': 7, 'collisions': 9}, {'tx': 9, 'success': 2, 'collisions': 7}, {'tx': 10, 'success': 4, 'collisions': 6}, {'tx': 16, 'success': 7, 'collisions': 9}, {'tx': 4, 'success': 0, 'collisions': 4}, {'tx': 5, 'success': 0, 'collisions': 5}, {'tx': 15, 'success': 6, 'collisions': 9}, {'tx': 10, 'success': 3, 'collisions': 7}, {'tx': 5, 'success': 0, 'collisions': 5}, {'tx': 5, 'success': 0, 'collisions': 5}, {'tx': 9, 'success': 3, 'collisions': 6}, {'tx': 4, 'success': 0, 'collisions': 4}, {'tx': 11, 'success': 5, 'collisions': 6}, {'tx': 11, 'success': 5, 'collisions': 6}, {'tx': 5, 'success': 0, 'collisions': 5}, {'tx': 6, 'success': 1, 'collisions': 5}, {'tx': 9, 'success': 3, 'collisions': 6}, {'tx': 17, 'success': 7, 'collisions': 10}, {'tx': 9, 'success': 2, 'collisions': 7}, {'tx': 4, 'success': 0, 'collisions': 4}, {'tx': 4, 'success': 0, 'collisions': 4}, {'tx': 5, 'success': 0, 'collisions': 5}, {'tx': 8, 'success': 2, 'collisions': 6}, {'tx': 5, 'success': 0, 'collisions': 5}, {'tx': 4, 'success': 0, 'collisions': 4}, {'tx': 4, 'success': 0, 'collisions': 4}, {'tx': 17, 'success': 5, 'collisions': 12}]"
255,40,56,319,83,236,0.7398119122257053,0.2601880877742947,0.4648,"[{'tx': 4, 'success': 0, 'collisions': 4}, {'tx': 10, 'success': 3, 'collisions': 7}, {'tx': 7, 'success': 1, 'collisions': 6}, {'tx': 10, 'success': 3, 'collisions': 7}, {'tx': 4, 'success': 0, 'collisions': 4}, {'tx': 9, 'success': 2, 'collisions': 7}, {'tx': 14, 'success': 6, 'collisions': 8}, {'tx': 14, 'success': 3, 'collisions': 11}, {'tx': 8, 'success': 1, 'collisions': 7}, {'tx': 4, 'success': 0, 'collisions': 4}, {'tx': 4, 'success': 0, 'collisions': 4}, {'tx': 11, 'success': 4, 'collisions': 7}, {'tx': 11, 'success': 4, 'collisions': 7}, {'tx': 5, 'success': 0, 'collisions': 5}, {'tx': 18, 'success': 9, 'collisions': 9}, {'tx': 4, 'success': 0, 'collisions': 4}, {'tx': 8, 'success': 1, 'collisions': 7}, {'tx': 5, 'success': 0, 'collisions': 5}, {'tx': 4, 'success': 0, 'collisions': 4}, {'tx': 8, 'success': 3, 'collisions': 5}, {'tx': 10, 'success': 3, 'collisions': 7}, {'tx': 5, 'success': 0, 'collisions': 5}, {'tx': 10, 'success': 3, 'collisions': 7}, {'tx': 5, 'success': 1, 'collisions': 4}, {'tx': 4, 'success': 0, 'collisions': 4}, {'tx': 9, 'success': 1, 'collisions': 8}, {'tx': 5, 'success': 0, 'collisions': 5}, {'tx': 6, 'success': 0, 'collisions': 6}, {'tx': 4, 'success': 0, 'collisions': 4}, {'tx': 10, 'success': 5, 'collisions': 5}, {'tx': 19, 'success': 11, 'collisions': 8}, {'tx': 4, 'success': 0, 'collisions': 4}, {'tx': 11, 'success': 6, 'collisions': 5}, {'tx': 5, 'success': 0, 'collisions': 5}, {'tx': 12, 'success': 4, 'collisions': 8}, {'tx': 6, 'success': 1, 'collisions': 5}, {'tx': 10, 'success': 2, 'collisions': 8}, {'tx': 11, 'success': 4, 'collisions': 7}, {'tx': 6, 'success': 1, 'collisions': 5}, {'tx': 5, 'success': 1, 'collisions': 4}]"
256,40,57,330,82,248,0.7515151515151515,0.24848484848484848,0.4674,"[{'tx': 9, 'success': 2, 'collisions': 7}, {'tx': 12, 'success': 5, 'collisions': 7}, {'tx': 5, 'success': 0, 'collisions': 5}, {'tx': 4, 'success': 0, 'collisions': 4}, {'tx': 14, 'success': 6, 'collisions': 8}, {'tx': 8, 'success': 1, 'collisions': 7}, {'tx': 9, 'success': 2, 'collisions': 7}, {'tx': 11, 'success': 4, 'collisions': 7}, {'tx': 5, 'success': 0, 'collisions': 5}, {'tx': 9, 'success': 3, 'collisions': 6}, {'tx': 5, 'success': 0, 'collisions': 5}, {'tx': 12, 'success': 5, 'collisions': 7}, {'tx': 5, 'success': 0, 'collisions': 5}, {'tx': 17, 'success': 8, 'collisions': 9}, {'tx': 11, 'success': 3, 'collisions': 8}, {'tx': 12, 'success': 4, 'collisions': 8}, {'tx': 4, 'success': 0, 'collisions': 4}, {'tx': 4, 'success': 0, 'collisions': 4}, {'tx': 4, 'success': 0, 'collisions': 4}, {'tx': 5, 'success': 1, 'collisions': 4}, {'tx': 9, 'success': 2, 'collisions': 7}, {'tx': 4, 'success': 0, 'collisions': 4}, {'tx': 6, 'success': 1, 'collisions': 5}, {'tx': 11, 'success': 3, 'collisions': 8}, {'tx': 14, 'success': 7, 'collisions': 7}, {'tx': 5, 'success': 0, 'collisions': 5}, {'tx': 4, 'success': 0, 'collisions': 4}, {'tx': 11, 'success': 3, 'collisions': 8}, {'tx': 10, 'success': 2, 'collisions': 8}, {'tx': 6, 'success': 1, 'collisions': 5}, {'tx': 8, 'success': 1, 'collisions': 7}, {'tx': 8, 'success': 1, 'collisions': 7}, {'tx': 11, 'success': 3, 'collisions': 8}, {'tx': 6, 'success': 1, 'collisions': 5}, {'tx': 4, 'success': 0, 'collisions': 4}, {'tx': 6, 'success': 0, 'collisions': 6}, {'tx': 11, 'success': 3, 'collisions': 8}, {'tx': 5, 'success': 1, 'collisions': 4}, {'tx': 17, 'success': 7, 'collisions': 10}, {'tx': 9, 'success': 2, 'collisions': 7}]"
257,40,58,324,90,234,0.7222222222222222,0.2777777777777778,0.522,"[{'tx': 9, 'success': 3, 'collisions': 6}, {'tx': 8, 'success': 2, 'collisions': 6}, {'tx': 9, 'success': 3, 'collisions': 6}, {'tx': 8, 'success': 2, 'collisions': 6}, {'tx': 7, 'success': 2, 'collisions': 5}, {'tx': 4, 'success': 0, 'collisions': 4}, {'tx': 11, 'success': 3, 'collisions': 8}, {'tx': 5, 'success': 0, 'collisions': 5}, {'tx': 11, 'success': 3, 'collisions': 8}, {'tx': 5, 'success': 0, 'collisions': 5}, {'tx': 4, 'success': 0, 'collisions': 4}, {'tx': 14, 'success': 6, 'collisions': 8}, {'tx': 4, 'success': 0, 'collisions': 4}, {'tx': 9, 'success': 2, 'collisions': 7}, {'tx': 9, 'success': 5, 'collisions': 4}, {'tx': 4, 'success': 0, 'collisions': 4}, {'tx': 4, 'success': 0, 'collisions': 4}, {'tx': 13, 'success': 5, 'collisions': 8}, {'tx': 5, 'success': 1, 'collisions': 4}, {'tx': 9, 'success': 4, 'collisions': 5}, {'tx': 4, 'success': 0, 'collisions': 4}, {'tx': 5, 'success': 0, 'collisions': 5}, {'tx': 12, 'success': 5, 'collisions': 7}, {'tx': 7, 'success': 1, 'collisions': 6}, {'tx': 7, 'success': 2, 'collisions': 5}, {'tx': 15, 'success': 7, 'collisions': 8}, {'tx': 14, 'success': 7, 'collisions': 7}, {'tx': 10, 'success': 3, 'collisions': 7}, {'tx': 4, 'success': 0, 'collisions': 4}, {'tx': 7, 'success': 1, 'collisions': 6}, {'tx': 7, 'success': 1, 'collisions': 6}, {'tx': 12, 'success': 4, 'collisions': 8}, {'tx': 7, 'success': 1, 'collisions': 6}, {'tx': 12, 'success': 5, 'collisions': 7}, {'tx': 7, 'success': 3, 'collisions': 4}, {'tx': 4, 'success': 0, 'collisions': 4}, {'tx': 9, 'success': 2, 'collisions': 7}, {'tx': 4, 'success': 0, 'collisions': 4}, {'tx': 12, 'success': 3, 'collisions': 9}, {'tx': 13, 'success': 4, 'collisions': 9}]"
258,40,59,313,84,229,0.731629392971246,0.268370607028754,0.4956,"[{'tx': 6, 'success': 2, 'collisions': 4}, {'tx': 8, 'success': 2, 'collisions': 6}, {'tx': 7, 'success': 4, 'collisions': 3}, {'tx': 12, 'success': 4, 'collisions': 8}, {'tx': 4, 'success': 0, 'collisions': 4}, {'tx': 4, 'success': 0, 'collisions': 4}, {'tx': 4, 'success': 0, 'collisions': 4}, {'tx': 5, 'success': 1, 'collisions': 4}, {'tx': 7, 'success': 2, 'collisions': 5}, {'tx': 3, 'success': 0, 'collisions': 3}, {'tx': 7, 'success': 1, 'collisions': 6}, {'tx': 6, 'success': 1, 'collisions': 5}, {'tx': 12, 'success': 4, 'collisions': 8}, {'tx': 16, 'success': 9, 'collisions': 7}, {'tx': 11, 'success': 2, 'collisions': 9}, {'tx': 9, 'success': 3, 'collisions': 6}, {'tx': 15, 'success': 9, 'collisions': 6}, {'tx': 6, 'success': 1, 'collisions': 5}, {'tx': 7, 'success': 1, 'collisions': 6}, {'tx': 5, 'success': 0, 'collisions': 5}, {'tx': 8, 'success': 2, 'collisions': 6}, {'tx': 10, 'success': 3, 'collisions': 7}, {'tx': 11, 'success': 4, 'collisions': 7}, {'tx': 4, 'success': 0, 'collisions': 4}, {'tx': 8, 'success': 1, 'collisions': 7}, {'tx': 13, 'success': 5, 'collisions': 8}, {'tx': 9, 'success': 2, 'collisions': 7}, {'tx': 9, 'success': 2, 'collisions': 7}, {'tx': 10, 'success': 2, 'collisions': 8}, {'tx': 4, 'success': 0, 'collisions': 4}, {'tx': 6, 'success': 2, 'collisions': 4}, {'tx': 8, 'success': 1, 'collisions': 7}, {'tx': 6, 'success': 0, 'collisions': 6}, {'tx': 17, 'success': 8, 'collisions': 9}, {'tx': 8, 'success': 2, 'collisions': 6}, {'tx': 7, 'success': 2, 'collisions': 5}, {'tx': 5, 'success': 0, 'collisions': 5}, {'tx': 4, 'success': 0, 'collisions': 4}, {'tx': 4, 'success': 0, 'collisions': 4}, {'tx': 8, 'success': 2, 'collisions': 6}]"
259,40,60,310,78,232,0.7483870967741936,0.25161290322580643,0.468,"[{'tx': 5, 'success': 0, 'collisions': 5}, {'tx': 8, 'success': 1, 'collisions': 7}, {'tx': 5, 'success': 2, 'collisions': 3}, {'tx': 4, 'success': 0, 'collisions': 4}, {'tx': 4, 'success': 0, 'collisions': 4}, {'tx': 9, 'success': 2, 'collisions': 7}, {'tx': 7, 'success': 1, 'collisions': 6}, {'tx': 8, 'success': 2, 'collisions': 6}, {'tx': 15, 'success': 8, 'collisions': 7}, {'tx': 4, 'success': 0, 'collisions': 4}, {'tx': 5, 'success': 0, 'collisions': 5}, {'tx': 5, 'success': 0, 'collisions': 5}, {'tx': 14, 'success': 5, 'collisions': 9}, {'tx': 8, 'success': 1, 'collisions': 7}, {'tx': 8, 'success': 2, 'collisions': 6}, {'tx': 8, 'success': 4, 'collisions': 4}, {'tx': 19, 'success': 7, 'collisions': 12}, {'tx': 12, 'success': 5, 'collisions': 7}, {'tx': 13, 'success': 6, 'collisions': 7}, {'tx': 5, 'success': 0, 'collisions': 5}, {'tx': 4, 'success': 0, 'collisions': 4}, {'tx': 4, 'success': 0, 'collisions': 4}, {'tx': 9, 'success': 3, 'collisions': 6}, {'tx': 4, 'success': 0, 'collisions': 4}, {'tx': 8, 'success': 2, 'collisions': 6}, {'tx': 5, 'success': 0, 'collisions': 5}, {'tx': 4, 'success': 0, 'collisions': 4}, {'tx': 8, 'success': 2, 'collisions': 6}, {'tx': 8, 'success': 1, 'collisions': 7}, {'tx': 10, 'success': 4, 'collisions': 6}, {'tx': 6, 'success': 1, 'collisions': 5}, {'tx': 10, 'success': 2, 'collisions': 8}, {'tx': 6, 'success': 1, 'collisions': 5}, {'tx': 8, 'success': 1, 'collisions': 7}, {'tx': 10, 'success': 2, 'collisions': 8}, {'tx': 4, 'success': 0, 'collisions': 4}, {'tx': 13, 'success': 6, 'collisions': 7}, {'tx': 4, 'success': 0, 'collisions': 4}, {'tx': 8, 'success': 2, 'collisions': 6}, {'tx': 11, 'success': 5, 'collisions': 6}]"
260,40,61,303,73,230,0.759075907590759,0.24092409240924093,0.4453,"[{'tx': 5, 'success': 0, 'collisions': 5}, {'tx': 11, 'success': 2, 'collisions': 9}, {'tx': 4, 'success': 0, 'collisions': 4}, {'tx': 4, 'success': 0, 'collisions': 4}, {'tx': 6, 'success': 0, 'collisions': 6}, {'tx': 5, 'success': 0, 'collisions': 5}, {'tx': 9, 'success': 1, 'collisions': 8}, {'tx': 4, 'success': 0, 'collisions': 4}, {'tx': 6, 'success': 2, 'collisions': 4}, {'tx': 6, 'success': 3, 'collisions': 3}, {'tx': 4, 'success': 0, 'collisions': 4}, {'tx': 7, 'success': 1, 'collisions': 6}, {'tx': 19, 'success': 8, 'collisions': 11}, {'tx': 4, 'success': 0, 'collisions': 4}, {'tx': 10, 'success': 3, 'collisions': 7}, {'tx': 5, 'success': 0, 'collisions': 5}, {'tx': 6, 'success': 2, 'collisions': 4}, {'tx': 5, 'success': 0, 'collisions': 5}, {'tx': 11, 'success': 3, 'collisions': 8}, {'tx': 4, 'success': 0, 'collisions': 4}, {'tx': 5, 'success': 0, 'collisions': 5}, {'tx': 16, 'success': 6, 'collisions': 10}, {'tx': 8, 'success': 3, 'collisions': 5}, {'tx': 11, 'success': 3, 'collisions': 8}, {'tx': 7, 'success': 1, 'collisions': 6}, {'tx': 10, 'success': 2, 'collisions': 8}, {'tx': 4, 'success': 0, 'collisions': 4}, {'tx': 6, 'success': 1, 'collisions': 5}, {'tx': 9, 'success': 2, 'collisions': 7}, {'tx': 8, 'success': 3, 'collisions': 5}, {'tx': 4, 'success': 0, 'collisions': 4}, {'tx': 10, 'success': 4, 'collisions': 6}, {'tx': 8, 'success': 3, 'collisions': 5}, {'tx': 10, 'success': 3, 'collisions': 7}, {'tx': 12, 'success': 5, 'collisions': 7}, {'tx': 4, 'success': 0, 'collisions': 4}, {'tx': 7, 'success': 2, 'collisions': 5}, {'tx': 10, 'success': 2, 'collisions': 8}, {'tx': 11, 'success': 5, 'collisions': 6}, {'tx': 8, 'success': 3, 'collisions': 5}]"
261,40,62,296,74,222,0.75,0.25,0.4588,"[{'tx': 10, 'success': 3, 'collisions': 7}, {'tx': 8, 'success': 2, 'collisions': 6}, {'tx': 7, 'success': 1, 'collisions': 6}, {'tx': 5, 'success': 0, 'collisions': 5}, {'tx': 8, 'success': 2, 'collisions': 6}, {'tx': 8, 'success': 1, 'collisions': 7}, {'tx': 10, 'success': 4, 'collisions': 6}, {'tx': 4, 'success': 0, 'collisions': 4}, {'tx': 11, 'success': 4, 'collisions': 7}, {'tx': 6, 'success': 1, 'collisions': 5}, {'tx': 9, 'success': 4, 'collisions': 5}, {'tx': 9, 'success': 2, 'collisions': 7}, {'tx': 7, 'success': 2, 'collisions': 5}, {'tx': 13, 'success': 5, 'collisions': 8}, {'tx': 4, 'success': 0, 'collisions': 4}, {'tx': 8, 'success': 2, 'collisions': 6}, {'tx': 6, 'success': 0, 'collisions': 6}, {'tx': 11, 'success': 4, 'collisions': 7}, {'tx': 16, 'success': 6, 'collisions': 10}, {'tx': 4, 'success': 0, 'collisions': 4}, {'tx': 4, 'success': 0, 'collisions': 4}, {'tx': 7, 'success': 2, 'collisions': 5}, {'tx': 15, 'success': 8, 'collisions': 7}, {'tx': 11, 'success': 6, 'collisions': 5}, {'tx': 9, 'success': 2, 'collisions': 7}, {'tx': 4, 'success': 0, 'collisions': 4}, {'tx': 4, 'success': 0, 'collisions': 4}, {'tx': 6, 'success': 1, 'collisions': 5}, {'tx': 9, 'success': 3, 'collisions': 6}, {'tx': 6, 'success': 1, 'collisions': 5}, {'tx': 4, 'success': 0, 'collisions': 4}, {'tx': 9, 'success': 2, 'collisions': 7}, {'tx': 6, 'success': 1, 'collisions': 5}, {'tx': 8, 'success': 2, 'collisions': 6}, {'tx': 4, 'success': 0, 'collisions': 4}, {'tx': 6, 'success': 1, 'collisions': 5}, {'tx': 5, 'success': 0, 'collisions': 5}, {'tx': 4, 'success': 0, 'collisions': 4}, {'tx': 7, 'success': 2, 'collisions': 5}, {'tx': 4, 'success': 0, 'collisions': 4}]"
262,40,63,299,71,228,0.7625418060200669,0.23745819397993312,0.4473,"[{'tx': 5, 'success': 1, 'collisions': 4}, {'tx': 5, 'success': 0, 'collisions': 5}, {'tx': 4, 'success': 0, 'collisions': 4}, {'tx': 15, 'success': 7, 'collisions': 8}, {'tx': 7, 'success': 1, 'collisions': 6}, {'tx': 4, 'success': 0, 'collisions': 4}, {'tx': 10, 'success': 2, 'collisions': 8}, {'tx': 14, 'success': 4, 'collisions': 10}, {'tx': 9, 'success': 2, 'collisions': 7}, {'tx': 5, 'success': 1, 'collisions': 4}, {'tx': 4, 'success': 0, 'collisions': 4}, {'tx': 4, 'success': 0, 'collisions': 4}, {'tx': 7, 'success': 1, 'collisions': 6}, {'tx': 7, 'success': 1, 'collisions': 6}, {'tx': 7, 'success': 2, 'collisions': 5}, {'tx': 4, 'success': 0, 'collisions': 4}, {'tx': 4, 'success': 1, 'collisions': 3}, {'tx': 8, 'success': 1, 'collisions': 7}, {'tx': 5, 'success': 1, 'collisions': 4}, {'tx': 8, 'success': 2, 'collisions': 6}, {'tx': 6, 'success': 1, 'collisions': 5}, {'tx': 5, 'success': 1, 'collisions': 4}, {'tx': 13, 'success': 4, 'collisions': 9}, {'tx': 5, 'success': 0, 'collisions': 5}, {'tx': 4, 'success': 0, 'collisions': 4}, {'tx': 10, 'success': 3, 'collisions': 7}, {'tx': 7, 'success': 2, 'collisions': 5}, {'tx': 4, 'success': 0, 'collisions': 4}, {'tx': 12, 'success': 5, 'collisions': 7}, {'tx': 14, 'success': 6, 'collisions': 8}, {'tx': 5, 'success': 1, 'collisions': 4}, {'tx': 12, 'success': 4, 'collisions': 8}, {'tx': 5, 'success': 0, 'collisions': 5}, {'tx': 7, 'success': 1, 'collisions': 6}, {'tx': 16, 'success': 8, 'collisions': 8}, {'tx': 4, 'success': 0, 'collisions': 4}, {'tx': 7, 'success': 1, 'collisions': 6}, {'tx': 8, 'success': 2, 'collisions': 6}, {'tx': 6, 'success': 1, 'collisions': 5}, {'tx': 13, 'success': 4, 'collisions': 9}]"
263,40,64,307,73,234,0.762214983713355,0.23778501628664495,0.4672,"[{'tx': 12, 'success': 5, 'collisions': 7}, {'tx': 12, 'success': 5, 'collisions': 7}, {'tx': 7, 'success': 2, 'collisions': 5}, {'tx': 5, 'success': 0, 'collisions': 5}, {'tx': 10, 'success': 4, 'collisions': 6}, {'tx': 5, 'success': 0, 'collisions': 5}, {'tx': 9, 'success': 3, 'collisions': 6}, {'tx': 4, 'success': 0, 'collisions': 4}, {'tx': 5, 'success': 0, 'collisions': 5}, {'tx': 8, 'success': 2, 'collisions': 6}, {'tx': 7, 'success': 1, 'collisions': 6}, {'tx': 11, 'success': 4, 'collisions': 7}, {'tx': 11, 'success': 4, 'collisions': 7}, {'tx': 10, 'success': 5, 'collisions': 5}, {'tx': 4, 'success': 0, 'collisions': 4}, {'tx': 8, 'success': 1, 'collisions': 7}, {'tx': 9, 'success': 3, 'collisions': 6}, {'tx': 5, 'success': 0, 'collisions': 5}, {'tx': 4, 'success': 0, 'collisions': 4}, {'tx': 4, 'success': 0, 'collisions': 4}, {'tx': 4, 'success': 0, 'collisions': 4}, {'tx': 6, 'success': 1, 'collisions': 5}, {'tx': 5, 'success': 0, 'collisions': 5}, {'tx': 5, 'success': 0, 'collisions': 5}, {'tx': 13, 'success': 5, 'collisions': 8}, {'tx': 13, 'success': 4, 'collisions': 9}, {'tx': 5, 'success': 0, 'collisions': 5}, {'tx': 4, 'success': 0, 'collisions': 4}, {'tx': 14, 'success': 4, 'collisions': 10}, {'tx': 10, 'success': 3, 'collisions': 7}, {'tx': 9, 'success': 3, 'collisions': 6}, {'tx': 4, 'success': 0, 'collisions': 4}, {'tx': 10, 'success': 2, 'collisions': 8}, {'tx': 7, 'success': 1, 'collisions': 6}, {'tx': 4, 'success': 0, 'collisions': 4}, {'tx': 10, 'success': 3, 'collisions': 7}, {'tx': 7, 'success': 1, 'collisions': 6}, {'tx': 11, 'success': 4, 'collisions': 7}, {'tx': 7, 'success': 1, 'collisions': 6}, {'tx': 9, 'success': 2, 'collisions': 7}]"
264,40,65,292,71,221,0.7568493150684932,0.24315068493150685,0.4615,"[{'tx': 6, 'success': 1, 'collisions': 5}, {'tx': 9, 'success': 2, 'collisions': 7}, {'tx': 7, 'success': 1, 'collisions': 6}, {'tx': 6, 'success': 0, 'collisions': 6}, {'tx': 4, 'success': 0, 'collisions': 4}, {'tx': 8, 'success': 2, 'collisions': 6}, {'tx': 4, 'success': 0, 'collisions': 4}, {'tx': 8, 'success': 2, 'collisions': 6}, {'tx': 4, 'success': 0, 'collisions': 4}, {'tx': 5, 'success': 0, 'collisions': 5}, {'tx': 4, 'success': 0, 'collisions': 4}, {'tx': 11, 'success': 3, 'collisions': 8}, {'tx': 5, 'success': 0, 'collisions': 5}, {'tx': 7, 'success': 2, 'collisions': 5}, {'tx': 4, 'success': 0, 'collisions': 4}, {'tx': 9, 'success': 4, 'collisions': 5}, {'tx': 6, 'success': 1, 'collisions': 5}, {'tx': 12, 'success': 6, 'collisions': 6}, {'tx': 14, 'success': 5, 'collisions': 9}, {'tx': 4, 'success': 0, 'collisions': 4}, {'tx': 6, 'success': 2, 'collisions': 4}, {'tx': 9, 'success': 3, 'collisions': 6}, {'tx': 10, 'success': 4, 'collisions': 6}, {'tx': 8, 'success': 2, 'collisions': 6}, {'tx': 12, 'success': 5, 'collisions': 7}, {'tx': 7, 'success': 1, 'collisions': 6}, {'tx': 10, 'success': 3, 'collisions': 7}, {'tx': 7, 'success': 1, 'collisions': 6}, {'tx': 6, 'success': 1, 'collisions': 5}, {'tx': 9, 'success': 2, 'collisions': 7}, {'tx': 5, 'success': 0, 'collisions': 5}, {'tx': 9, 'success': 3, 'collisions': 6}, {'tx': 4, 'success': 0, 'collisions': 4}, {'tx': 14, 'success': 5, 'collisions': 9}, {'tx': 7, 'success': 2, 'collisions': 5}, {'tx': 4, 'success': 0, 'collisions': 4}, {'tx': 4, 'success': 0, 'collisions': 4}, {'tx': 9, 'success': 2, 'collisions': 7}, {'tx': 3, 'success': 0, 'collisions': 3}, {'tx': 12, 'success': 6, 'collisions': 6}]"
265,40,66,287,69,218,0.759581881533101,0.24041811846689895,0.4554,"[{'tx': 7, 'success': 1, 'collisions': 6}, {'tx': 5, 'success': 0, 'collisions': 5}, {'tx': 9, 'success': 4, 'collisions': 5}, {'tx': 8, 'success': 1, 'collisions': 7}, {'tx': 8, 'success': 3, 'collisions': 5}, {'tx': 7, 'success': 1, 'collisions': 6}, {'tx': 10, 'success': 3, 'collisions': 7}, {'tx': 12, 'success': 6, 'collisions': 6}, {'tx': 7, 'success': 1, 'collisions': 6}, {'tx': 4, 'success': 0, 'collisions': 4}, {'tx': 19, 'success': 8, 'collisions': 11}, {'tx': 4, 'success': 0, 'collisions': 4}, {'tx': 6, 'success': 2, 'collisions': 4}, {'tx': 14, 'success': 7, 'collisions': 7}, {'tx': 8, 'success': 2, 'collisions': 6}, {'tx': 6, 'success': 1, 'collisions': 5}, {'tx': 6, 'success': 1, 'collisions': 5}, {'tx': 5, 'success': 0, 'collisions': 5}, {'tx': 12, 'success': 5, 'collisions': 7}, {'tx': 8, 'success': 1, 'collisions': 7}, {'tx': 4, 'success': 0, 'collisions': 4}, {'tx': 4, 'success': 0, 'collisions': 4}, {'tx': 4, 'success': 0, 'collisions': 4}, {'tx': 7, 'success': 1, 'collisions': 6}, {'tx': 10, 'success': 5, 'collisions': 5}, {'tx': 5, 'success': 0, 'collisions': 5}, {'tx': 5, 'success': 0, 'collisions': 5}, {'tx': 4, 'success': 0, 'collisions': 4}, {'tx': 4, 'success': 0, 'collisions': 4}, {'tx': 5, 'success': 0, 'collisions': 5}, {'tx': 7, 'success': 1, 'collisions': 6}, {'tx': 4, 'success': 0, 'collisions': 4}, {'tx': 8, 'success': 2, 'collisions': 6}, {'tx': 9, 'success': 1, 'collisions': 8}, {'tx': 9, 'success': 3, 'collisions': 6}, {'tx': 7, 'success': 2, 'collisions': 5}, {'tx': 3, 'success': 0, 'collisions': 3}, {'tx': 7, 'success': 2, 'collisions': 5}, {'tx': 11, 'success': 5, 'collisions': 6}, {'tx': 5, 'success': 0, 'collisions': 5}]"
266,40,67,289,69,220,0.7612456747404844,0.23875432525951557,0.4623,"[{'tx': 4, 'success': 0, 'collisions': 4}, {'tx': 10, 'success': 3, 'collisions': 7}, {'tx': 5, 'success': 2, 'collisions': 3}, {'tx': 6, 'success': 1, 'collisions': 5}, {'tx': 4, 'success': 0, 'collisions': 4}, {'tx': 9, 'success': 2, 'collisions': 7}, {'tx': 8, 'success': 2, 'collisions': 6}, {'tx': 6, 'success': 1, 'collisions': 5}, {'tx': 14, 'success': 6, 'collisions': 8}, {'tx': 18, 'success': 7, 'collisions': 11}, {'tx': 4, 'success': 0, 'collisions': 4}, {'tx': 6, 'success': 2, 'collisions': 4}, {'tx': 11, 'success': 3, 'collisions': 8}, {'tx': 9, 'success': 2, 'collisions': 7}, {'tx': 5, 'success': 0, 'collisions': 5}, {'tx': 4, 'success': 0, 'collisions': 4}, {'tx': 4, 'success': 0, 'collisions': 4}, {'tx': 10, 'success': 4, 'collisions': 6}, {'tx': 4, 'success': 0, 'collisions': 4}, {'tx': 9, 'success': 2, 'collisions': 7}, {'tx': 9, 'success': 4, 'collisions': 5}, {'tx': 6, 'success': 1, 'collisions': 5}, {'tx': 4, 'success': 0, 'collisions': 4}, {'tx': 6, 'success': 0, 'collisions': 6}, {'tx': 4, 'success': 0, 'collisions': 4}, {'tx': 4, 'success': 0, 'collisions': 4}, {'tx': 7, 'success': 1, 'collisions': 6}, {'tx': 11, 'success': 4, 'collisions': 7}, {'tx': 8, 'success': 2, 'collisions': 6}, {'tx': 7, 'success': 2, 'collisions': 5}, {'tx': 7, 'success': 2, 'collisions': 5}, {'tx': 11, 'success': 4, 'collisions': 7}, {'tx': 13, 'success': 5, 'collisions': 8}, {'tx': 4, 'success': 0, 'collisions': 4}, {'tx': 4, 'success': 0, 'collisions': 4}, {'tx': 6, 'success': 1, 'collisions': 5}, {'tx': 3, 'success': 0, 'collisions': 3}, {'tx': 6, 'success': 1, 'collisions': 5}, {'tx': 8, 'success': 2, 'collisions': 6}, {'tx': 11, 'success': 3, 'collisions': 8}]"
267,40,68,284,71,213,0.75,0.25,0.4828,"[{'tx': 8, 'success': 3, 'collisions': 5}, {'tx': 6, 'success': 1, 'collisions': 5}, {'tx': 5, 'success': 0, 'collisions': 5}, {'tx': 6, 'success': 2, 'collisions': 4}, {'tx': 6, 'success': 1, 'collisions': 5}, {'tx': 10, 'success': 4, 'collisions': 6}, {'tx': 13, 'success': 4, 'collisions': 9}, {'tx': 5, 'success': 0, 'collisions': 5}, {'tx': 4, 'success': 0, 'collisions': 4}, {'tx': 7, 'success': 1, 'collisions': 6}, {'tx': 10, 'success': 3, 'collisions': 7}, {'tx': 3, 'success': 0, 'collisions': 3}, {'tx': 11, 'success': 6, 'collisions': 5}, {'tx': 8, 'success': 1, 'collisions': 7}, {'tx': 8, 'success': 5, 'collisions': 3}, {'tx': 6, 'success': 1, 'collisions': 5}, {'tx': 8, 'success': 2, 'collisions': 6}, {'tx': 10, 'success': 3, 'collisions': 7}, {'tx': 6, 'success': 1, 'collisions': 5}, {'tx': 5, 'success': 0, 'collisions': 5}, {'tx': 6, 'success': 1, 'collisions': 5}, {'tx': 8, 'success': 3, 'collisions': 5}, {'tx': 9, 'success': 2, 'collisions': 7}, {'tx': 6, 'success': 1, 'collisions': 5}, {'tx': 8, 'success': 2, 'collisions': 6}, {'tx': 11, 'success': 5, 'collisions': 6}, {'tx': 6, 'success': 1, 'collisions': 5}, {'tx': 12, 'success': 4, 'collisions': 8}, {'tx': 4, 'success': 0, 'collisions': 4}, {'tx': 4, 'success': 0, 'collisions': 4}, {'tx': 5, 'success': 0, 'collisions': 5}, {'tx': 3, 'success': 0, 'collisions': 3}, {'tx': 8, 'success': 1, 'collisions': 7}, {'tx': 10, 'success': 3, 'collisions': 7}, {'tx': 4, 'success': 0, 'collisions': 4}, {'tx': 9, 'success': 3, 'collisions': 6}, {'tx': 13, 'success': 6, 'collisions': 7}, {'tx': 4, 'success': 0, 'collisions': 4}, {'tx': 4, 'success': 0, 'collisions': 4}, {'tx': 5, 'success': 1, 'collisions': 4}]"
268,40,69,279,68,211,0.7562724014336918,0.24372759856630824,0.4692,"[{'tx': 9, 'success': 3, 'collisions': 6}, {'tx': 4, 'success': 0, 'collisions': 4}, {'tx': 7, 'success': 1, 'collisions': 6}, {'tx': 11, 'success': 5, 'collisions': 6}, {'tx': 4, 'success': 0, 'collisions': 4}, {'tx': 7, 'success': 1, 'collisions': 6}, {'tx': 5, 'success': 2, 'collisions': 3}, {'tx': 11, 'success': 5, 'collisions': 6}, {'tx': 6, 'success': 1, 'collisions': 5}, {'tx': 5, 'success': 1, 'collisions': 4}, {'tx': 4, 'success': 0, 'collisions': 4}, {'tx': 8, 'success': 2, 'collisions': 6}, {'tx': 6, 'success': 1, 'collisions': 5}, {'tx': 9, 'success': 4, 'collisions': 5}, {'tx': 11, 'success': 4, 'collisions': 7}, {'tx': 4, 'success': 0, 'collisions': 4}, {'tx': 4, 'success': 0, 'collisions': 4}, {'tx': 9, 'success': 3, 'collisions': 6}, {'tx': 9, 'success': 2, 'collisions': 7}, {'tx': 4, 'success': 0, 'collisions': 4}, {'tx': 6, 'success': 1, 'collisions': 5}, {'tx': 9, 'success': 4, 'collisions': 5}, {'tx': 3, 'success': 0, 'collisions': 3}, {'tx': 6, 'success': 0, 'collisions': 6}, {'tx': 6, 'success': 1, 'collisions': 5}, {'tx': 9, 'success': 2, 'collisions': 7}, {'tx': 10, 'success': 5, 'collisions': 5}, {'tx': 9, 'success': 2, 'collisions': 7}, {'tx': 4, 'success': 0, 'collisions': 4}, {'tx': 4, 'success': 0, 'collisions': 4}, {'tx': 12, 'success': 3, 'collisions': 9}, {'tx': 7, 'success': 2, 'collisions': 5}, {'tx': 8, 'success': 2, 'collisions': 6}, {'tx': 4, 'success': 0, 'collisions': 4}, {'tx': 12, 'success': 4, 'collisions': 8}, {'tx': 7, 'success': 1, 'collisions': 6}, {'tx': 7, 'success': 1, 'collisions': 6}, {'tx': 4, 'success': 0, 'collisions': 4}, {'tx': 7, 'success': 2, 'collisions': 5}, {'tx': 8, 'success': 3, 'collisions': 5}]"
269,40,70,284,62,222,0.7816901408450704,0.21830985915492956,0.434,"[{'tx': 13, 'success': 4, 'collisions': 9}, {'tx': 9, 'success': 2, 'collisions': 7}, {'tx': 8, 'success': 3, 'collisions': 5}, {'tx': 7, 'success': 2, 'collisions': 5}, {'tx': 9, 'success': 3, 'collisions': 6}, {'tx': 8, 'success': 2, 'collisions': 6}, {'tx': 10, 'success': 5, 'collisions': 5}, {'tx': 5, 'success': 0, 'collisions': 5}, {'tx': 4, 'success': 0, 'collisions': 4}, {'tx': 4, 'success': 0, 'collisions': 4}, {'tx': 7, 'success': 1, 'collisions': 6}, {'tx': 13, 'success': 5, 'collisions': 8}, {'tx': 7, 'success': 1, 'collisions': 6}, {'tx': 5, 'success': 0, 'collisions': 5}, {'tx': 11, 'success': 5, 'collisions': 6}, {'tx': 4, 'success': 0, 'collisions': 4}, {'tx': 9, 'success': 2, 'collisions': 7}, {'tx': 12, 'success': 6, 'collisions': 6}, {'tx': 7, 'success': 1, 'collisions': 6}, {'tx': 4, 'success': 0, 'collisions': 4}, {'tx': 8, 'success': 1, 'collisions': 7}, {'tx': 4, 'success': 0, 'collisions': 4}, {'tx': 4, 'success': 0, 'collisions': 4}, {'tx': 8, 'success': 1, 'collisions': 7}, {'tx': 9, 'success': 2, 'collisions': 7}, {'tx': 5, 'success': 0, 'collisions': 5}, {'tx': 10, 'success': 3, 'collisions': 7}, {'tx': 4, 'success': 0, 'collisions': 4}, {'tx': 6, 'success': 1, 'collisions': 5}, {'tx': 6, 'success': 1, 'collisions': 5}, {'tx': 4, 'success': 0, 'collisions': 4}, {'tx': 4, 'success': 0, 'collisions': 4}, {'tx': 5, 'success': 0, 'collisions': 5}, {'tx': 7, 'success': 2, 'collisions': 5}, {'tx': 4, 'success': 0, 'collisions': 4}, {'tx': 9, 'success': 3, 'collisions': 6}, {'tx': 7, 'success': 1, 'collisions': 6}, {'tx': 9, 'success': 2, 'collisions': 7}, {'tx': 6, 'success': 1, 'collisions': 5}, {'tx': 9, 'success': 2, 'collisions': 7}]"
270,40,71,264,70,194,0.7348484848484849,0.26515151515151514,0.497,"[{'tx': 6, 'success': 1, 'collisions': 5}, {'tx': 11, 'success': 4, 'collisions': 7}, {'tx': 13, 'success': 6, 'collisions': 7}, {'tx': 8, 'success': 2, 'collisions': 6}, {'tx': 5, 'success': 1, 'collisions': 4}, {'tx': 7, 'success': 1, 'collisions': 6}, {'tx': 12, 'success': 5, 'collisions': 7}, {'tx': 4, 'success': 0, 'collisions': 4}, {'tx': 4, 'success': 0, 'collisions': 4}, {'tx': 4, 'success': 0, 'collisions': 4}, {'tx': 7, 'success': 2, 'collisions': 5}, {'tx': 5, 'success': 1, 'collisions': 4}, {'tx': 3, 'success': 0, 'collisions': 3}, {'tx': 4, 'success': 0, 'collisions': 4}, {'tx': 5, 'success': 1, 'collisions': 4}, {'tx': 6, 'success': 1, 'collisions': 5}, {'tx': 4, 'success': 1, 'collisions': 3}, {'tx': 12, 'success': 7, 'collisions': 5}, {'tx': 4, 'success': 0, 'collisions': 4}, {'tx': 4, 'success': 0, 'collisions': 4}, {'tx': 7, 'success': 3, 'collisions': 4}, {'tx': 11, 'success': 6, 'collisions': 5}, {'tx': 6, 'success': 1, 'collisions': 5}, {'tx': 4, 'success': 0, 'collisions': 4}, {'tx': 4, 'success': 0, 'collisions': 4}, {'tx': 3, 'success': 0, 'collisions': 3}, {'tx': 4, 'success': 0, 'collisions': 4}, {'tx': 5, 'success': 0, 'collisions': 5}, {'tx': 10, 'success': 4, 'collisions': 6}, {'tx': 9, 'success': 2, 'collisions': 7}, {'tx': 12, 'success': 4, 'collisions': 8}, {'tx': 8, 'success': 2, 'collisions': 6}, {'tx': 6, 'success': 1, 'collisions': 5}, {'tx': 14, 'success': 6, 'collisions': 8}, {'tx': 7, 'success': 2, 'collisions': 5}, {'tx': 7, 'success': 3, 'collisions': 4}, {'tx': 3, 'success': 0, 'collisions': 3}, {'tx': 5, 'success': 0, 'collisions': 5}, {'tx': 7, 'success': 3, 'collisions': 4}, {'tx': 4, 'success': 0, 'collisions': 4}]"
271,40,72,274,60,214,0.781021897810219,0.21897810218978103,0.432,"[{'tx': 12, 'success': 5, 'collisions': 7}, {'tx': 11, 'success': 4, 'collisions': 7}, {'tx': 9, 'success': 1, 'collisions': 8}, {'tx': 4, 'success': 1, 'collisions': 3}, {'tx': 7, 'success': 1, 'collisions': 6}, {'tx': 4, 'success': 0, 'collisions': 4}, {'tx': 11, 'success': 3, 'collisions': 8}, {'tx': 4, 'success': 0, 'collisions': 4}, {'tx': 6, 'success': 1, 'collisions': 5}, {'tx': 7, 'success': 1, 'collisions': 6}, {'tx': 7, 'success': 1, 'collisions': 6}, {'tx': 4, 'success': 0, 'collisions': 4}, {'tx': 5, 'success': 1, 'collisions': 4}, {'tx': 12, 'success': 6, 'collisions': 6}, {'tx': 4, 'success': 0, 'collisions': 4}, {'tx': 4, 'success': 0, 'collisions': 4}, {'tx': 8, 'success': 2, 'collisions': 6}, {'tx': 4, 'success': 0, 'collisions': 4}, {'tx': 8, 'success': 2, 'collisions': 6}, {'tx': 4, 'success': 0, 'collisions': 4}, {'tx': 8, 'success': 2, 'collisions': 6}, {'tx': 4, 'success': 0, 'collisions': 4}, {'tx': 6, 'success': 0, 'collisions': 6}, {'tx': 8, 'success': 2, 'collisions': 6}, {'tx': 8, 'success': 3, 'collisions': 5}, {'tx': 7, 'success': 1, 'collisions': 6}, {'tx': 4, 'success': 0, 'collisions': 4}, {'tx': 10, 'success': 4, 'collisions': 6}, {'tx': 14, 'success': 5, 'collisions': 9}, {'tx': 4, 'success': 0, 'collisions': 4}, {'tx': 14, 'success': 6, 'collisions': 8}, {'tx': 4, 'success': 0, 'collisions': 4}, {'tx': 4, 'success': 0, 'collisions': 4}, {'tx': 9, 'success': 3, 'collisions': 6}, {'tx': 6, 'success': 1, 'collisions': 5}, {'tx': 6, 'success': 1, 'collisions': 5}, {'tx': 9, 'success': 2, 'collisions': 7}, {'tx': 5, 'success': 1, 'collisions': 4}, {'tx': 4, 'success': 0, 'collisions': 4}, {'tx': 5, 'success': 0, 'collisions': 5}]"
272,40,73,270,65,205,0.7592592592592593,0.24074074074074073,0.4745,"[{'tx': 9, 'success': 3, 'collisions': 6}, {'tx': 4, 'success': 0, 'collisions': 4}, {'tx': 4, 'success': 0, 'collisions': 4}, {'tx': 4, 'success': 0, 'collisions': 4}, {'tx': 7, 'success': 1, 'collisions': 6}, {'tx': 10, 'success': 2, 'collisions': 8}, {'tx': 4, 'success': 0, 'collisions': 4}, {'tx': 6, 'success': 1, 'collisions': 5}, {'tx': 8, 'success': 2, 'collisions': 6}, {'tx': 8, 'success': 3, 'collisions': 5}, {'tx': 9, 'success': 3, 'collisions': 6}, {'tx': 15, 'success': 6, 'collisions': 9}, {'tx': 7, 'success': 1, 'collisions': 6}, {'tx': 8, 'success': 1, 'collisions': 7}, {'tx': 6, 'success': 1, 'collisions': 5}, {'tx': 6, 'success': 1, 'collisions': 5}, {'tx': 8, 'success': 1, 'collisions': 7}, {'tx': 5, 'success': 1, 'collisions': 4}, {'tx': 3, 'success': 0, 'collisions': 3}, {'tx': 5, 'success': 1, 'collisions': 4}, {'tx': 4, 'success': 0, 'collisions': 4}, {'tx': 5, 'success': 0, 'collisions': 5}, {'tx': 14, 'success': 6, 'collisions': 8}, {'tx': 7, 'success': 2, 'collisions': 5}, {'tx': 14, 'success': 8, 'collisions': 6}, {'tx': 3, 'success': 0, 'collisions': 3}, {'tx': 7, 'success': 4, 'collisions': 3}, {'tx': 4, 'success': 0, 'collisions': 4}, {'tx': 11, 'success': 6, 'collisions': 5}, {'tx': 7, 'success': 1, 'collisions': 6}, {'tx': 4, 'success': 0, 'collisions': 4}, {'tx': 7, 'success': 2, 'collisions': 5}, {'tx': 6, 'success': 1, 'collisions': 5}, {'tx': 7, 'success': 2, 'collisions': 5}, {'tx': 4, 'success': 0, 'collisions': 4}, {'tx': 4, 'success': 0, 'collisions': 4}, {'tx': 6, 'success': 2, 'collisions': 4}, {'tx': 4, 'success': 0, 'collisions': 4}, {'tx': 10, 'success': 2, 'collisions': 8}, {'tx': 6, 'success': 1, 'collisions': 5}]"
273,40,74,259,63,196,0.7567567567567568,0.24324324324324326,0.4662,"[{'tx': 8, 'success': 2, 'collisions': 6}, {'tx': 5, 'success': 2, 'collisions': 3}, {'tx': 6, 'success': 3, 'collisions': 3}, {'tx': 4, 'success': 0, 'collisions': 4}, {'tx': 4, 'success': 0, 'collisions': 4}, {'tx': 4, 'success': 0, 'collisions': 4}, {'tx': 4, 'success': 0, 'collisions': 4}, {'tx': 4, 'success': 0, 'collisions': 4}, {'tx': 6, 'success': 1, 'collisions': 5}, {'tx': 4, 'success': 0, 'collisions': 4}, {'tx': 7, 'success': 3, 'collisions': 4}, {'tx': 4, 'success': 1, 'collisions': 3}, {'tx': 10, 'success': 3, 'collisions': 7}, {'tx': 13, 'success': 7, 'collisions': 6}, {'tx': 5, 'success': 1, 'collisions': 4}, {'tx': 8, 'success': 2, 'collisions': 6}, {'tx': 14, 'success': 5, 'collisions': 9}, {'tx': 16, 'success': 9, 'collisions': 7}, {'tx': 4, 'success': 0, 'collisions': 4}, {'tx': 4, 'success': 0, 'collisions': 4}, {'tx': 4, 'success': 0, 'collisions': 4}, {'tx': 4, 'success': 0, 'collisions': 4}, {'tx': 10, 'success': 4, 'collisions': 6}, {'tx': 7, 'success': 1, 'collisions': 6}, {'tx': 7, 'success': 1, 'collisions': 6}, {'tx': 6, 'success': 1, 'collisions': 5}, {'tx': 6, 'success': 2, 'collisions': 4}, {'tx': 4, 'success': 0, 'collisions': 4}, {'tx': 4, 'success': 0, 'collisions': 4}, {'tx': 7, 'success': 2, 'collisions': 5}, {'tx': 3, 'success': 0, 'collisions': 3}, {'tx': 11, 'success': 5, 'collisions': 6}, {'tx': 8, 'success': 2, 'collisions': 6}, {'tx': 6, 'success': 1, 'collisions': 5}, {'tx': 4, 'success': 0, 'collisions': 4}, {'tx': 4, 'success': 0, 'collisions': 4}, {'tx': 9, 'success': 2, 'collisions': 7}, {'tx': 4, 'success': 0, 'collisions': 4}, {'tx': 13, 'success': 3, 'collisions': 10}, {'tx': 4, 'success': 0, 'collisions': 4}]"
274,40,75,263,55,208,0.7908745247148289,0.20912547528517111,0.4125,"[{'tx': 8, 'success': 2, 'collisions': 6}, {'tx': 9, 'success': 3, 'collisions': 6}, {'tx': 6, 'success': 2, 'collisions': 4}, {'tx': 5, 'success': 1, 'collisions': 4}, {'tx': 4, 'success': 0, 'collisions': 4}, {'tx': 4, 'success': 0, 'collisions': 4}, {'tx': 8, 'success': 1, 'collisions': 7}, {'tx': 6, 'success': 1, 'collisions': 5}, {'tx': 12, 'success': 4, 'collisions': 8}, {'tx': 4, 'success': 0, 'collisions': 4}, {'tx': 5, 'success': 0, 'collisions': 5}, {'tx': 8, 'success': 2, 'collisions': 6}, {'tx': 4, 'success': 0, 'collisions': 4}, {'tx': 8, 'success': 2, 'collisions': 6}, {'tx': 4, 'success': 0, 'collisions': 4}, {'tx': 4, 'success': 0, 'collisions': 4}, {'tx': 8, 'success': 2, 'collisions': 6}, {'tx': 4, 'success': 0, 'collisions': 4}, {'tx': 7, 'success': 2, 'collisions': 5}, {'tx': 5, 'success': 0, 'collisions': 5}, {'tx': 8, 'success': 2, 'collisions': 6}, {'tx': 6, 'success': 1, 'collisions': 5}, {'tx': 10, 'success': 4, 'collisions': 6}, {'tx': 9, 'success': 2, 'collisions': 7}, {'tx': 5, 'success': 0, 'collisions': 5}, {'tx': 4, 'success': 0, 'collisions': 4}, {'tx': 9, 'success': 2, 'collisions': 7}, {'tx': 9, 'success': 4, 'collisions': 5}, {'tx': 5, 'success': 0, 'collisions': 5}, {'tx': 4, 'success': 0, 'collisions': 4}, {'tx': 9, 'success': 3, 'collisions': 6}, {'tx': 8, 'success': 2, 'collisions': 6}, {'tx': 16, 'success': 8, 'collisions': 8}, {'tx': 5, 'success': 0, 'collisions': 5}, {'tx': 5, 'success': 0, 'collisions': 5}, {'tx': 6, 'success': 1, 'collisions': 5}, {'tx': 10, 'success': 4, 'collisions': 6}, {'tx': 4, 'success': 0, 'collisions': 4}, {'tx': 4, 'success': 0, 'collisions': 4}, {'tx': 4, 'success': 0, 'collisions': 4}]"
275,40,76,264,63,201,0.7613636363636364,0.23863636363636365,0.4788,"[{'tx': 4, 'success': 1, 'collisions': 3}, {'tx': 10, 'success': 5, 'collisions': 5}, {'tx': 9, 'success': 3, 'collisions': 6}, {'tx': 4, 'success': 0, 'collisions': 4}, {'tx': 7, 'success': 2, 'collisions': 5}, {'tx': 8, 'success': 2, 'collisions': 6}, {'tx': 10, 'success': 3, 'collisions': 7}, {'tx': 8, 'success': 2, 'collisions': 6}, {'tx': 4, 'success': 0, 'collisions': 4}, {'tx': 4, 'success': 1, 'collisions': 3}, {'tx': 10, 'success': 3, 'collisions': 7}, {'tx': 13, 'success': 4, 'collisions': 9}, {'tx': 4, 'success': 0, 'collisions': 4}, {'tx': 10, 'success': 3, 'collisions': 7}, {'tx': 8, 'success': 3, 'collisions': 5}, {'tx': 11, 'success': 6, 'collisions': 5}, {'tx': 4, 'success': 0, 'collisions': 4}, {'tx': 4, 'success': 0, 'collisions': 4}, {'tx': 9, 'success': 3, 'collisions': 6}, {'tx': 4, 'success': 0, 'collisions': 4}, {'tx': 6, 'success': 1, 'collisions': 5}, {'tx': 4, 'success': 0, 'collisions': 4}, {'tx': 6, 'success': 1, 'collisions': 5}, {'tx': 4, 'success': 0, 'collisions': 4}, {'tx': 6, 'success': 1, 'collisions': 5}, {'tx': 4, 'success': 0, 'collisions': 4}, {'tx': 7, 'success': 1, 'collisions': 6}, {'tx': 7, 'success': 3, 'collisions': 4}, {'tx': 4, 'success': 0, 'collisions': 4}, {'tx': 3, 'success': 0, 'collisions': 3}, {'tx': 8, 'success': 1, 'collisions': 7}, {'tx': 4, 'success': 0, 'collisions': 4}, {'tx': 10, 'success': 3, 'collisions': 7}, {'tx': 9, 'success': 4, 'collisions': 5}, {'tx': 4, 'success': 0, 'collisions': 4}, {'tx': 8, 'success': 3, 'collisions': 5}, {'tx': 9, 'success': 2, 'collisions': 7}, {'tx': 4, 'success': 0, 'collisions': 4}, {'tx': 4, 'success': 0, 'collisions': 4}, {'tx': 8, 'success': 2, 'collisions': 6}]"
276,40,77,263,56,207,0.7870722433460076,0.21292775665399238,0.4312,"[{'tx': 8, 'success': 2, 'collisions': 6}, {'tx': 4, 'success': 0, 'collisions': 4}, {'tx': 4, 'success': 0, 'collisions': 4}, {'tx': 4, 'success': 0, 'collisions': 4}, {'tx': 11, 'success': 4, 'collisions': 7}, {'tx': 4, 'success': 0, 'collisions': 4}, {'tx': 5, 'success': 1, 'collisions': 4}, {'tx': 10, 'success': 2, 'collisions': 8}, {'tx': 8, 'success': 2, 'collisions': 6}, {'tx': 4, 'success': 0, 'collisions': 4}, {'tx': 5, 'success': 0, 'collisions': 5}, {'tx': 12, 'success': 4, 'collisions': 8}, {'tx': 10, 'success': 2, 'collisions': 8}, {'tx': 7, 'success': 2, 'collisions': 5}, {'tx': 10, 'success': 3, 'collisions': 7}, {'tx': 10, 'success': 4, 'collisions': 6}, {'tx': 4, 'success': 0, 'collisions': 4}, {'tx': 5, 'success': 0, 'collisions': 5}, {'tx': 5, 'success': 0, 'collisions': 5}, {'tx': 11, 'success': 4, 'collisions': 7}, {'tx': 4, 'success': 0, 'collisions': 4}, {'tx': 6, 'success': 2, 'collisions': 4}, {'tx': 5, 'success': 1, 'collisions': 4}, {'tx': 14, 'success': 7, 'collisions': 7}, {'tx': 4, 'success': 0, 'collisions': 4}, {'tx': 4, 'success': 0, 'collisions': 4}, {'tx': 6, 'success': 1, 'collisions': 5}, {'tx': 4, 'success': 0, 'collisions': 4}, {'tx': 6, 'success': 1, 'collisions': 5}, {'tx': 5, 'success': 0, 'collisions': 5}, {'tx': 7, 'success': 2, 'collisions': 5}, {'tx': 7, 'success': 1, 'collisions': 6}, {'tx': 4, 'success': 0, 'collisions': 4}, {'tx': 6, 'success': 3, 'collisions': 3}, {'tx': 7, 'success': 2, 'collisions': 5}, {'tx': 8, 'success': 3, 'collisions': 5}, {'tx': 4, 'success': 0, 'collisions': 4}, {'tx': 6, 'success': 1, 'collisions': 5}, {'tx': 5, 'success': 0, 'collisions': 5}, {'tx': 10, 'success': 2, 'collisions': 8}]"
277,40,78,244,54,190,0.7786885245901639,0.22131147540983606,0.4212,"[{'tx': 9, 'success': 3, 'collisions': 6}, {'tx': 5, 'success': 0, 'collisions': 5}, {'tx': 4, 'success': 0, 'collisions': 4}, {'tx': 12, 'success': 6, 'collisions': 6}, {'tx': 5, 'success': 1, 'collisions': 4}, {'tx': 14, 'success': 6, 'collisions': 8}, {'tx': 10, 'success': 4, 'collisions': 6}, {'tx': 7, 'success': 2, 'collisions': 5}, {'tx': 7, 'success': 2, 'collisions': 5}, {'tx': 8, 'success': 2, 'collisions': 6}, {'tx': 11, 'success': 5, 'collisions': 6}, {'tx': 10, 'success': 4, 'collisions': 6}, {'tx': 5, 'success': 0, 'collisions': 5}, {'tx': 4, 'success': 0, 'collisions': 4}, {'tx': 4, 'success': 0, 'collisions': 4}, {'tx': 3, 'success': 0, 'collisions': 3}, {'tx': 4, 'success': 0, 'collisions': 4}, {'tx': 4, 'success': 0, 'collisions': 4}, {'tx': 4, 'success': 0, 'collisions': 4}, {'tx': 4, 'success': 0, 'collisions': 4}, {'tx': 8, 'success': 4, 'collisions': 4}, {'tx': 3, 'success': 0, 'collisions': 3}, {'tx': 4, 'success': 0, 'collisions': 4}, {'tx': 4, 'success': 0, 'collisions': 4}, {'tx': 6, 'success': 2, 'collisions': 4}, {'tx': 4, 'success': 0, 'collisions': 4}, {'tx': 5, 'success': 0, 'collisions': 5}, {'tx': 5, 'success': 0, 'collisions': 5}, {'tx': 8, 'success': 2, 'collisions': 6}, {'tx': 5, 'success': 0, 'collisions': 5}, {'tx': 8, 'success': 2, 'collisions': 6}, {'tx': 8, 'success': 3, 'collisions': 5}, {'tx': 4, 'success': 0, 'collisions': 4}, {'tx': 8, 'success': 2, 'collisions': 6}, {'tx': 4, 'success': 0, 'collisions': 4}, {'tx': 5, 'success': 1, 'collisions': 4}, {'tx': 8, 'success': 2, 'collisions': 6}, {'tx': 6, 'success': 1, 'collisions': 5}, {'tx': 4, 'success': 0, 'collisions': 4}, {'tx': 3, 'success': 0, 'collisions': 3}]"
278,40,79,251,60,191,0.7609561752988048,0.23904382470119523,0.474,"[{'tx': 6, 'success': 1, 'collisions': 5}, {'tx': 4, 'success': 1, 'collisions': 3}, {'tx': 10, 'success': 4, 'collisions': 6}, {'tx': 9, 'success': 3, 'collisions': 6}, {'tx': 5, 'success': 1, 'collisions': 4}, {'tx': 3, 'success': 0, 'collisions': 3}, {'tx': 5, 'success': 0, 'collisions': 5}, {'tx': 4, 'success': 0, 'collisions': 4}, {'tx': 13, 'success': 5, 'collisions': 8}, {'tx': 6, 'success': 2, 'collisions': 4}, {'tx': 4, 'success': 0, 'collisions': 4}, {'tx': 8, 'success': 3, 'collisions': 5}, {'tx': 8, 'success': 2, 'collisions': 6}, {'tx': 11, 'success': 4, 'collisions': 7}, {'tx': 9, 'success': 5, 'collisions': 4}, {'tx': 5, 'success': 0, 'collisions': 5}, {'tx': 4, 'success': 0, 'collisions': 4}, {'tx': 7, 'success': 1, 'collisions': 6}, {'tx': 6, 'success': 1, 'collisions': 5}, {'tx': 4, 'success': 0, 'collisions': 4}, {'tx': 4, 'success': 0, 'collisions': 4}, {'tx': 3, 'success': 0, 'collisions': 3}, {'tx': 11, 'success': 4, 'collisions': 7}, {'tx': 9, 'success': 3, 'collisions': 6}, {'tx': 4, 'success': 0, 'collisions': 4}, {'tx': 4, 'success': 0, 'collisions': 4}, {'tx': 10, 'success': 4, 'collisions': 6}, {'tx': 6, 'success': 1, 'collisions': 5}, {'tx': 7, 'success': 1, 'collisions': 6}, {'tx': 4, 'success': 0, 'collisions': 4}, {'tx': 3, 'success': 0, 'collisions': 3}, {'tx': 11, 'success': 6, 'collisions': 5}, {'tx': 3, 'success': 0, 'collisions': 3}, {'tx': 3, 'success': 0, 'collisions': 3}, {'tx': 4, 'success': 0, 'collisions': 4}, {'tx': 4, 'success': 0, 'collisions': 4}, {'tx': 13, 'success': 5, 'collisions': 8}, {'tx': 8, 'success': 3, 'collisions': 5}, {'tx': 4, 'success': 0, 'collisions': 4}, {'tx': 5, 'success': 0, 'collisions': 5}]"
279,40,80,252,58,194,0.7698412698412699,0.23015873015873015,0.464,"[{'tx': 5, 'success': 1, 'collisions': 4}, {'tx': 10, 'success': 5, 'collisions': 5}, {'tx': 7, 'success': 1, 'collisions': 6}, {'tx': 3, 'success': 0, 'collisions': 3}, {'tx': 3, 'success': 0, 'collisions': 3}, {'tx': 4, 'success': 0, 'collisions': 4}, {'tx': 9, 'success': 3, 'collisions': 6}, {'tx': 12, 'success': 7, 'collisions': 5}, {'tx': 9, 'success': 3, 'collisions': 6}, {'tx': 6, 'success': 1, 'collisions': 5}, {'tx': 4, 'success': 0, 'collisions': 4}, {'tx': 4, 'success': 0, 'collisions': 4}, {'tx': 9, 'success': 3, 'collisions': 6}, {'tx': 4, 'success': 0, 'collisions': 4}, {'tx': 6, 'success': 1, 'collisions': 5}, {'tx': 4, 'success': 0, 'collisions': 4}, {'tx': 8, 'success': 3, 'collisions': 5}, {'tx': 8, 'success': 2, 'collisions': 6}, {'tx': 4, 'success': 0, 'collisions': 4}, {'tx': 8, 'success': 3, 'collisions': 5}, {'tx': 6, 'success': 1, 'collisions': 5}, {'tx': 8, 'success': 3, 'collisions': 5}, {'tx': 4, 'success': 0, 'collisions': 4}, {'tx': 7, 'success': 1, 'collisions': 6}, {'tx': 4, 'success': 0, 'collisions': 4}, {'tx': 5, 'success': 1, 'collisions': 4}, {'tx': 7, 'success': 2, 'collisions': 5}, {'tx': 8, 'success': 2, 'collisions': 6}, {'tx': 11, 'success': 4, 'collisions': 7}, {'tx': 4, 'success': 0, 'collisions': 4}, {'tx': 4, 'success': 0, 'collisions': 4}, {'tx': 9, 'success': 2, 'collisions': 7}, {'tx': 11, 'success': 4, 'collisions': 7}, {'tx': 4, 'success': 0, 'collisions': 4}, {'tx': 9, 'success': 4, 'collisions': 5}, {'tx': 5, 'success': 0, 'collisions': 5}, {'tx': 4, 'success': 0, 'collisions': 4}, {'tx': 7, 'success': 1, 'collisions': 6}, {'tx': 5, 'success': 0, 'collisions': 5}, {'tx': 3, 'success': 0, 'collisions': 3}]"
280,40,81,254,49,205,0.8070866141732284,0.19291338582677164,0.3969,"[{'tx': 7, 'success': 2, 'collisions': 5}, {'tx': 3, 'success': 0, 'collisions': 3}, {'tx': 6, 'success': 1, 'collisions': 5}, {'tx': 8, 'success': 2, 'collisions': 6}, {'tx': 4, 'success': 0, 'collisions': 4}, {'tx': 5, 'success': 0, 'collisions': 5}, {'tx': 6, 'success': 0, 'collisions': 6}, {'tx': 6, 'success': 1, 'collisions': 5}, {'tx': 6, 'success': 2, 'collisions': 4}, {'tx': 10, 'success': 4, 'collisions': 6}, {'tx': 14, 'success': 5, 'collisions': 9}, {'tx': 4, 'success': 0, 'collisions': 4}, {'tx': 11, 'success': 4, 'collisions': 7}, {'tx': 8, 'success': 2, 'collisions': 6}, {'tx': 8, 'success': 2, 'collisions': 6}, {'tx': 11, 'success': 3, 'collisions': 8}, {'tx': 4, 'success': 0, 'collisions': 4}, {'tx': 9, 'success': 2, 'collisions': 7}, {'tx': 4, 'success': 0, 'collisions': 4}, {'tx': 9, 'success': 2, 'collisions': 7}, {'tx': 8, 'success': 1, 'collisions': 7}, {'tx': 3, 'success': 0, 'collisions': 3}, {'tx': 10, 'success': 3, 'collisions': 7}, {'tx': 4, 'success': 0, 'collisions': 4}, {'tx': 10, 'success': 3, 'collisions': 7}, {'tx': 4, 'success': 0, 'collisions': 4}, {'tx': 3, 'success': 0, 'collisions': 3}, {'tx': 3, 'success': 0, 'collisions': 3}, {'tx': 4, 'success': 0, 'collisions': 4}, {'tx': 7, 'success': 2, 'collisions': 5}, {'tx': 4, 'success': 0, 'collisions': 4}, {'tx': 4, 'success': 0, 'collisions': 4}, {'tx': 7, 'success': 2, 'collisions': 5}, {'tx': 6, 'success': 1, 'collisions': 5}, {'tx': 4, 'success': 0, 'collisions': 4}, {'tx': 7, 'success': 1, 'collisions': 6}, {'tx': 7, 'success': 1, 'collisions': 6}, {'tx': 7, 'success': 2, 'collisions': 5}, {'tx': 4, 'success': 0, 'collisions': 4}, {'tx': 5, 'success': 1, 'collisions': 4}]"
281,40,82,242,50,192,0.7933884297520661,0.2066115702479339,0.41,"[{'tx': 4, 'success': 0, 'collisions': 4}, {'tx': 4, 'success': 0, 'collisions': 4}, {'tx': 6, 'success': 2, 'collisions': 4}, {'tx': 6, 'success': 1, 'collisions': 5}, {'tx': 3, 'success': 0, 'collisions': 3}, {'tx': 5, 'success': 0, 'collisions': 5}, {'tx': 5, 'success': 0, 'collisions': 5}, {'tx': 8, 'success': 3, 'collisions': 5}, {'tx': 10, 'success': 4, 'collisions': 6}, {'tx': 6, 'success': 2, 'collisions': 4}, {'tx': 4, 'success': 0, 'collisions': 4}, {'tx': 4, 'success': 0, 'collisions': 4}, {'tx': 9, 'success': 3, 'collisions': 6}, {'tx': 10, 'success': 5, 'collisions': 5}, {'tx': 8, 'success': 2, 'collisions': 6}, {'tx': 9, 'success': 3, 'collisions': 6}, {'tx': 8, 'success': 2, 'collisions': 6}, {'tx': 7, 'success': 3, 'collisions': 4}, {'tx': 4, 'success': 0, 'collisions': 4}, {'tx': 8, 'success': 2, 'collisions': 6}, {'tx': 8, 'success': 2, 'collisions': 6}, {'tx': 7, 'success': 1, 'collisions': 6}, {'tx': 4, 'success': 0, 'collisions': 4}, {'tx': 4, 'success': 0, 'collisions': 4}, {'tx': 8, 'success': 2, 'collisions': 6}, {'tx': 4, 'success': 0, 'collisions': 4}, {'tx': 8, 'success': 2, 'collisions': 6}, {'tx': 4, 'success': 0, 'collisions': 4}, {'tx': 6, 'success': 1, 'collisions': 5}, {'tx': 4, 'success': 0, 'collisions': 4}, {'tx': 4, 'success': 0, 'collisions': 4}, {'tx': 8, 'success': 3, 'collisions': 5}, {'tx': 6, 'success': 1, 'collisions': 5}, {'tx': 3, 'success': 0, 'collisions': 3}, {'tx': 8, 'success': 2, 'collisions': 6}, {'tx': 3, 'success': 0, 'collisions': 3}, {'tx': 7, 'success': 1, 'collisions': 6}, {'tx': 10, 'success': 3, 'collisions': 7}, {'tx': 4, 'success': 0, 'collisions': 4}, {'tx': 4, 'success': 0, 'collisions': 4}]"
282,40,83,238,54,184,0.773109243697479,0.226890756302521,0.4482,"[{'tx': 3, 'success': 0, 'collisions': 3}, {'tx': 5, 'success': 1, 'collisions': 4}, {'tx': 4, 'success': 0, 'collisions': 4}, {'tx': 8, 'success': 2, 'collisions': 6}, {'tx': 8, 'success': 2, 'collisions': 6}, {'tx': 6, 'success': 2, 'collisions': 4}, {'tx': 9, 'success': 4, 'collisions': 5}, {'tx': 7, 'success': 1, 'collisions': 6}, {'tx': 3, 'success': 0, 'collisions': 3}, {'tx': 3, 'success': 0, 'collisions': 3}, {'tx': 6, 'success': 1, 'collisions': 5}, {'tx': 6, 'success': 1, 'collisions': 5}, {'tx': 6, 'success': 1, 'collisions': 5}, {'tx': 4, 'success': 0, 'collisions': 4}, {'tx': 4, 'success': 0, 'collisions': 4}, {'tx': 4, 'success': 0, 'collisions': 4}, {'tx': 4, 'success': 0, 'collisions': 4}, {'tx': 9, 'success': 3, 'collisions': 6}, {'tx': 8, 'success': 2, 'collisions': 6}, {'tx': 4, 'success': 0, 'collisions': 4}, {'tx': 5, 'success': 0, 'collisions': 5}, {'tx': 4, 'success': 0, 'collisions': 4}, {'tx': 6, 'success': 2, 'collisions': 4}, {'tx': 6, 'success': 1, 'collisions': 5}, {'tx': 7, 'success': 1, 'collisions': 6}, {'tx': 11, 'success': 5, 'collisions': 6}, {'tx': 12, 'success': 6, 'collisions': 6}, {'tx': 3, 'success': 0, 'collisions': 3}, {'tx': 10, 'success': 5, 'collisions': 5}, {'tx': 7, 'success': 3, 'collisions': 4}, {'tx': 13, 'success': 4, 'collisions': 9}, {'tx': 4, 'success': 0, 'collisions': 4}, {'tx': 9, 'success': 3, 'collisions': 6}, {'tx': 4, 'success': 0, 'collisions': 4}, {'tx': 8, 'success': 3, 'collisions': 5}, {'tx': 3, 'success': 0, 'collisions': 3}, {'tx': 4, 'success': 1, 'collisions': 3}, {'tx': 4, 'success': 0, 'collisions': 4}, {'tx': 3, 'success': 0, 'collisions': 3}, {'tx': 4, 'success': 0, 'collisions': 4}]"
283,40,84,240,54,186,0.775,0.225,0.4536,"[{'tx': 11, 'success': 5, 'collisions': 6}, {'tx': 4, 'success': 0, 'collisions': 4}, {'tx': 9, 'success': 4, 'collisions': 5}, {'tx': 6, 'success': 2, 'collisions': 4}, {'tx': 7, 'success': 1, 'collisions': 6}, {'tx': 6, 'success': 2, 'collisions': 4}, {'tx': 8, 'success': 2, 'collisions': 6}, {'tx': 4, 'success': 0, 'collisions': 4}, {'tx': 4, 'success': 0, 'collisions': 4}, {'tx': 10, 'success': 4, 'collisions': 6}, {'tx': 3, 'success': 0, 'collisions': 3}, {'tx': 8, 'success': 2, 'collisions': 6}, {'tx': 4, 'success': 0, 'collisions': 4}, {'tx': 4, 'success': 0, 'collisions': 4}, {'tx': 6, 'success': 1, 'collisions': 5}, {'tx': 10, 'success': 5, 'collisions': 5}, {'tx': 5, 'success': 0, 'collisions': 5}, {'tx': 5, 'success': 0, 'collisions': 5}, {'tx': 11, 'success': 6, 'collisions': 5}, {'tx': 13, 'success': 6, 'collisions': 7}, {'tx': 5, 'success': 0, 'collisions': 5}, {'tx': 3, 'success': 0, 'collisions': 3}, {'tx': 5, 'success': 1, 'collisions': 4}, {'tx': 7, 'success': 4, 'collisions': 3}, {'tx': 4, 'success': 0, 'collisions': 4}, {'tx': 4, 'success': 0, 'collisions': 4}, {'tx': 3, 'success': 0, 'collisions': 3}, {'tx': 4, 'success': 0, 'collisions': 4}, {'tx': 4, 'success': 1, 'collisions': 3}, {'tx': 5, 'success': 1, 'collisions': 4}, {'tx': 4, 'success': 0, 'collisions': 4}, {'tx': 4, 'success': 0, 'collisions': 4}, {'tx': 4, 'success': 0, 'collisions': 4}, {'tx': 3, 'success': 0, 'collisions': 3}, {'tx': 7, 'success': 1, 'collisions': 6}, {'tx': 3, 'success': 0, 'collisions': 3}, {'tx': 9, 'success': 2, 'collisions': 7}, {'tx': 8, 'success': 1, 'collisions': 7}, {'tx': 11, 'success': 3, 'collisions': 8}, {'tx': 5, 'success': 0, 'collisions': 5}]"
284,40,85,240,56,184,0.7666666666666667,0.23333333333333334,0.476,"[{'tx': 4, 'success': 0, 'collisions': 4}, {'tx': 6, 'success': 1, 'collisions': 5}, {'tx': 4, 'success': 0, 'collisions': 4}, {'tx': 4, 'success': 0, 'collisions': 4}, {'tx': 4, 'success': 0, 'collisions': 4}, {'tx': 5, 'success': 1, 'collisions': 4}, {'tx': 6, 'success': 1, 'collisions': 5}, {'tx': 3, 'success': 0, 'collisions': 3}, {'tx': 10, 'success': 4, 'collisions': 6}, {'tx': 6, 'success': 1, 'collisions': 5}, {'tx': 4, 'success': 0, 'collisions': 4}, {'tx': 4, 'success': 0, 'collisions': 4}, {'tx': 6, 'success': 2, 'collisions': 4}, {'tx': 5, 'success': 1, 'collisions': 4}, {'tx': 5, 'success': 1, 'collisions': 4}, {'tx': 11, 'success': 6, 'collisions': 5}, {'tx': 12, 'success': 5, 'collisions': 7}, {'tx': 6, 'success': 1, 'collisions': 5}, {'tx': 4, 'success': 1, 'collisions': 3}, {'tx': 4, 'success': 0, 'collisions': 4}, {'tx': 11, 'success': 5, 'collisions': 6}, {'tx': 6, 'success': 1, 'collisions': 5}, {'tx': 4, 'success': 0, 'collisions': 4}, {'tx': 4, 'success': 0, 'collisions': 4}, {'tx': 6, 'success': 2, 'collisions': 4}, {'tx': 9, 'success': 2, 'collisions': 7}, {'tx': 3, 'success': 0, 'collisions': 3}, {'tx': 11, 'success': 4, 'collisions': 7}, {'tx': 3, 'success': 0, 'collisions': 3}, {'tx': 8, 'success': 3, 'collisions': 5}, {'tx': 10, 'success': 4, 'collisions': 6}, {'tx': 4, 'success': 0, 'collisions': 4}, {'tx': 4, 'success': 0, 'collisions': 4}, {'tx': 10, 'success': 5, 'collisions': 5}, {'tx': 10, 'success': 3, 'collisions': 7}, {'tx': 3, 'success': 0, 'collisions': 3}, {'tx': 4, 'success': 0, 'collisions': 4}, {'tx': 7, 'success': 1, 'collisions': 6}, {'tx': 4, 'success': 0, 'collisions': 4}, {'tx': 6, 'success': 1, 'collisions': 5}]"
285,40,86,224,53,171,0.7633928571428571,0.23660714285714285,0.4558,"[{'tx': 3, 'success': 0, 'collisions': 3}, {'tx': 7, 'success': 3, 'collisions': 4}, {'tx': 3, 'success': 0, 'collisions': 3}, {'tx': 8, 'success': 3, 'collisions': 5}, {'tx': 8, 'success': 2, 'collisions': 6}, {'tx': 8, 'success': 4, 'collisions': 4}, {'tx': 4, 'success': 0, 'collisions': 4}, {'tx': 3, 'success': 0, 'collisions': 3}, {'tx': 11, 'success': 5, 'collisions': 6}, {'tx': 7, 'success': 3, 'collisions': 4}, {'tx': 4, 'success': 0, 'collisions': 4}, {'tx': 7, 'success': 3, 'collisions': 4}, {'tx': 5, 'success': 0, 'collisions': 5}, {'tx': 3, 'success': 0, 'collisions': 3}, {'tx': 3, 'success': 0, 'collisions': 3}, {'tx': 3, 'success': 0, 'collisions': 3}, {'tx': 3, 'success': 0, 'collisions': 3}, {'tx': 3, 'success': 0, 'collisions': 3}, {'tx': 10, 'success': 3, 'collisions': 7}, {'tx': 7, 'success': 2, 'collisions': 5}, {'tx': 6, 'success': 2, 'collisions': 4}, {'tx': 3, 'success': 0, 'collisions': 3}, {'tx': 10, 'success': 5, 'collisions': 5}, {'tx': 7, 'success': 1, 'collisions': 6}, {'tx': 5, 'success': 1, 'collisions': 4}, {'tx': 4, 'success': 0, 'collisions': 4}, {'tx': 8, 'success': 3, 'collisions': 5}, {'tx': 4, 'success': 1, 'collisions': 3}, {'tx': 5, 'success': 1, 'collisions': 4}, {'tx': 7, 'success': 1, 'collisions': 6}, {'tx': 4, 'success': 0, 'collisions': 4}, {'tx': 4, 'success': 0, 'collisions': 4}, {'tx': 3, 'success': 0, 'collisions': 3}, {'tx': 4, 'success': 0, 'collisions': 4}, {'tx': 6, 'success': 2, 'collisions': 4}, {'tx': 6, 'success': 1, 'collisions': 5}, {'tx': 6, 'success': 1, 'collisions': 5}, {'tx': 10, 'success': 3, 'collisions': 7}, {'tx': 7, 'success': 2, 'collisions': 5}, {'tx': 5, 'success': 1, 'collisions': 4}]"
286,40,87,235,50,185,0.7872340425531915,0.2127659574468085,0.435,"[{'tx': 10, 'success': 4, 'collisions': 6}, {'tx': 3, 'success': 0, 'collisions': 3}, {'tx': 7, 'success': 2, 'collisions': 5}, {'tx': 10, 'success': 4, 'collisions': 6}, {'tx': 4, 'success': 0, 'collisions': 4}, {'tx': 4, 'success': 0, 'collisions': 4}, {'tx': 4, 'success': 0, 'collisions': 4}, {'tx': 4, 'success': 1, 'collisions': 3}, {'tx': 7, 'success': 2, 'collisions': 5}, {'tx': 8, 'success': 2, 'collisions': 6}, {'tx': 8, 'success': 3, 'collisions': 5}, {'tx': 8, 'success': 1, 'collisions': 7}, {'tx': 6, 'success': 1, 'collisions': 5}, {'tx': 6, 'success': 1, 'collisions': 5}, {'tx': 4, 'success': 0, 'collisions': 4}, {'tx': 3, 'success': 0, 'collisions': 3}, {'tx': 4, 'success': 0, 'collisions': 4}, {'tx': 4, 'success': 0, 'collisions': 4}, {'tx': 8, 'success': 2, 'collisions': 6}, {'tx': 6, 'success': 1, 'collisions': 5}, {'tx': 7, 'success': 1, 'collisions': 6}, {'tx': 6, 'success': 1, 'collisions': 5}, {'tx': 4, 'success': 0, 'collisions': 4}, {'tx': 8, 'success': 4, 'collisions': 4}, {'tx': 6, 'success': 1, 'collisions': 5}, {'tx': 4, 'success': 0, 'collisions': 4}, {'tx': 3, 'success': 0, 'collisions': 3}, {'tx': 8, 'success': 2, 'collisions': 6}, {'tx': 3, 'success': 0, 'collisions': 3}, {'tx': 4, 'success': 0, 'collisions': 4}, {'tx': 3, 'success': 0, 'collisions': 3}, {'tx': 4, 'success': 0, 'collisions': 4}, {'tx': 10, 'success': 5, 'collisions': 5}, {'tx': 7, 'success': 2, 'collisions': 5}, {'tx': 6, 'success': 1, 'collisions': 5}, {'tx': 9, 'success': 4, 'collisions': 5}, {'tx': 5, 'success': 1, 'collisions': 4}, {'tx': 4, 'success': 0, 'collisions': 4}, {'tx': 5, 'success': 0, 'collisions': 5}, {'tx': 11, 'success': 4, 'collisions': 7}]"
287,40,88,229,48,181,0.7903930131004366,0.2096069868995633,0.4224,"[{'tx': 4, 'success': 1, 'collisions': 3}, {'tx': 4, 'success': 0, 'collisions': 4}, {'tx': 7, 'success': 3, 'collisions': 4}, {'tx': 6, 'success': 1, 'collisions': 5}, {'tx': 4, 'success': 0, 'collisions': 4}, {'tx': 7, 'success': 1, 'collisions': 6}, {'tx': 3, 'success': 0, 'collisions': 3}, {'tx': 9, 'success': 4, 'collisions': 5}, {'tx': 7, 'success': 1, 'collisions': 6}, {'tx': 4, 'success': 0, 'collisions': 4}, {'tx': 4, 'success': 0, 'collisions': 4}, {'tx': 7, 'success': 2, 'collisions': 5}, {'tx': 8, 'success': 3, 'collisions': 5}, {'tx': 9, 'success': 4, 'collisions': 5}, {'tx': 4, 'success': 0, 'collisions': 4}, {'tx': 4, 'success': 0, 'collisions': 4}, {'tx': 6, 'success': 1, 'collisions': 5}, {'tx': 4, 'success': 0, 'collisions': 4}, {'tx': 5, 'success': 0, 'collisions': 5}, {'tx': 4, 'success': 0, 'collisions': 4}, {'tx': 8, 'success': 4, 'collisions': 4}, {'tx': 5, 'success': 0, 'collisions': 5}, {'tx': 8, 'success': 3, 'collisions': 5}, {'tx': 7, 'success': 1, 'collisions': 6}, {'tx': 6, 'success': 1, 'collisions': 5}, {'tx': 4, 'success': 1, 'collisions': 3}, {'tx': 5, 'success': 1, 'collisions': 4}, {'tx': 4, 'success': 0, 'collisions': 4}, {'tx': 5, 'success': 1, 'collisions': 4}, {'tx': 7, 'success': 2, 'collisions': 5}, {'tx': 3, 'success': 0, 'collisions': 3}, {'tx': 3, 'success': 0, 'collisions': 3}, {'tx': 3, 'success': 0, 'collisions': 3}, {'tx': 12, 'success': 5, 'collisions': 7}, {'tx': 4, 'success': 0, 'collisions': 4}, {'tx': 4, 'success': 0, 'collisions': 4}, {'tx': 8, 'success': 2, 'collisions': 6}, {'tx': 8, 'success': 2, 'collisions': 6}, {'tx': 8, 'success': 3, 'collisions': 5}, {'tx': 7, 'success': 1, 'collisions': 6}]"
288,40,89,226,42,184,0.8141592920353983,0.18584070796460178,0.3738,"[{'tx': 3, 'success': 0, 'collisions': 3}, {'tx': 5, 'success': 0, 'collisions': 5}, {'tx': 4, 'success': 0, 'collisions': 4}, {'tx': 7, 'success': 3, 'collisions': 4}, {'tx': 5, 'success': 1, 'collisions': 4}, {'tx': 9, 'success': 3, 'collisions': 6}, {'tx': 4, 'success': 0, 'collisions': 4}, {'tx': 4, 'success': 0, 'collisions': 4}, {'tx': 3, 'success': 0, 'collisions': 3}, {'tx': 8, 'success': 2, 'collisions': 6}, {'tx': 4, 'success': 0, 'collisions': 4}, {'tx': 4, 'success': 0, 'collisions': 4}, {'tx': 6, 'success': 1, 'collisions': 5}, {'tx': 6, 'success': 1, 'collisions': 5}, {'tx': 3, 'success': 0, 'collisions': 3}, {'tx': 11, 'success': 4, 'collisions': 7}, {'tx': 5, 'success': 0, 'collisions': 5}, {'tx': 4, 'success': 0, 'collisions': 4}, {'tx': 7, 'success': 2, 'collisions': 5}, {'tx': 7, 'success': 1, 'collisions': 6}, {'tx': 8, 'success': 2, 'collisions': 6}, {'tx': 4, 'success': 0, 'collisions': 4}, {'tx': 10, 'success': 4, 'collisions': 6}, {'tx': 7, 'success': 1, 'collisions': 6}, {'tx': 6, 'success': 1, 'collisions': 5}, {'tx': 7, 'success': 2, 'collisions': 5}, {'tx': 4, 'success': 0, 'collisions': 4}, {'tx': 5, 'success': 0, 'collisions': 5}, {'tx': 6, 'success': 1, 'collisions': 5}, {'tx': 6, 'success': 2, 'collisions': 4}, {'tx': 10, 'success': 4, 'collisions': 6}, {'tx': 4, 'success': 0, 'collisions': 4}, {'tx': 7, 'success': 2, 'collisions': 5}, {'tx': 9, 'success': 3, 'collisions': 6}, {'tx': 5, 'success': 0, 'collisions': 5}, {'tx': 6, 'success': 2, 'collisions': 4}, {'tx': 3, 'success': 0, 'collisions': 3}, {'tx': 3, 'success': 0, 'collisions': 3}, {'tx': 3, 'success': 0, 'collisions': 3}, {'tx': 4, 'success': 0, 'collisions': 4}]"
289,40,90,219,48,171,0.7808219178082192,0.2191780821917808,0.432,"[{'tx': 3, 'success': 0, 'collisions': 3}, {'tx': 4, 'success': 0, 'collisions': 4}, {'tx': 8, 'success': 2, 'collisions': 6}, {'tx': 5, 'success': 1, 'collisions': 4}, {'tx': 5, 'success': 0, 'collisions': 5}, {'tx': 6, 'success': 1, 'collisions': 5}, {'tx': 3, 'success': 0, 'collisions': 3}, {'tx': 8, 'success': 2, 'collisions': 6}, {'tx': 6, 'success': 1, 'collisions': 5}, {'tx': 9, 'success': 4, 'collisions': 5}, {'tx': 6, 'success': 1, 'collisions': 5}, {'tx': 11, 'success': 5, 'collisions': 6}, {'tx': 5, 'success': 1, 'collisions': 4}, {'tx': 4, 'success': 0, 'collisions': 4}, {'tx': 4, 'success': 0, 'collisions': 4}, {'tx': 8, 'success': 4, 'collisions': 4}, {'tx': 7, 'success': 2, 'collisions': 5}, {'tx': 6, 'success': 2, 'collisions': 4}, {'tx': 12, 'success': 4, 'collisions': 8}, {'tx': 3, 'success': 0, 'collisions': 3}, {'tx': 9, 'success': 4, 'collisions': 5}, {'tx': 3, 'success': 0, 'collisions': 3}, {'tx': 3, 'success': 0, 'collisions': 3}, {'tx': 3, 'success': 0, 'collisions': 3}, {'tx': 3, 'success': 0, 'collisions': 3}, {'tx': 6, 'success': 2, 'collisions': 4}, {'tx': 7, 'success': 2, 'collisions': 5}, {'tx': 8, 'success': 4, 'collisions': 4}, {'tx': 4, 'success': 0, 'collisions': 4}, {'tx': 8, 'success': 3, 'collisions': 5}, {'tx': 5, 'success': 1, 'collisions': 4}, {'tx': 4, 'success': 0, 'collisions': 4}, {'tx': 3, 'success': 0, 'collisions': 3}, {'tx': 3, 'success': 0, 'collisions': 3}, {'tx': 3, 'success': 0, 'collisions': 3}, {'tx': 4, 'success': 0, 'collisions': 4}, {'tx': 6, 'success': 1, 'collisions': 5}, {'tx': 5, 'success': 1, 'collisions': 4}, {'tx': 5, 'success': 0, 'collisions': 5}, {'tx': 4, 'success': 0, 'collisions': 4}]"
290,40,91,226,48,178,0.7876106194690266,0.21238938053097345,0.4368,"[{'tx': 7, 'success': 2, 'collisions': 5}, {'tx': 4, 'success': 0, 'collisions': 4}, {'tx': 6, 'success': 1, 'collisions': 5}, {'tx': 6, 'success': 0, 'collisions': 6}, {'tx': 3, 'success': 0, 'collisions': 3}, {'tx': 6, 'success': 2, 'collisions': 4}, {'tx': 5, 'success': 1, 'collisions': 4}, {'tx': 3, 'success': 0, 'collisions': 3}, {'tx': 5, 'success': 0, 'collisions': 5}, {'tx': 6, 'success': 1, 'collisions': 5}, {'tx': 6, 'success': 2, 'collisions': 4}, {'tx': 4, 'success': 0, 'collisions': 4}, {'tx': 4, 'success': 0, 'collisions': 4}, {'tx': 5, 'success': 1, 'collisions': 4}, {'tx': 5, 'success': 2, 'collisions': 3}, {'tx': 5, 'success': 1, 'collisions': 4}, {'tx': 9, 'success': 3, 'collisions': 6}, {'tx': 12, 'success': 7, 'collisions': 5}, {'tx': 5, 'success': 2, 'collisions': 3}, {'tx': 6, 'success': 1, 'collisions': 5}, {'tx': 5, 'success': 0, 'collisions': 5}, {'tx': 4, 'success': 0, 'collisions': 4}, {'tx': 6, 'success': 1, 'collisions': 5}, {'tx': 8, 'success': 3, 'collisions': 5}, {'tx': 3, 'success': 0, 'collisions': 3}, {'tx': 4, 'success': 0, 'collisions': 4}, {'tx': 10, 'success': 3, 'collisions': 7}, {'tx': 3, 'success': 0, 'collisions': 3}, {'tx': 4, 'success': 0, 'collisions': 4}, {'tx': 3, 'success': 0, 'collisions': 3}, {'tx': 11, 'success': 5, 'collisions': 6}, {'tx': 8, 'success': 2, 'collisions': 6}, {'tx': 6, 'success': 2, 'collisions': 4}, {'tx': 4, 'success': 0, 'collisions': 4}, {'tx': 7, 'success': 1, 'collisions': 6}, {'tx': 9, 'success': 3, 'collisions': 6}, {'tx': 3, 'success': 0, 'collisions': 3}, {'tx': 6, 'success': 1, 'collisions': 5}, {'tx': 6, 'success': 1, 'collisions': 5}, {'tx': 4, 'success': 0, 'collisions': 4}]"
291,40,92,219,41,178,0.8127853881278538,0.1872146118721461,0.3772,"[{'tx': 5, 'success': 0, 'collisions': 5}, {'tx': 4, 'success': 1, 'collisions': 3}, {'tx': 6, 'success': 1, 'collisions': 5}, {'tx': 11, 'success': 4, 'collisions': 7}, {'tx': 5, 'success': 1, 'collisions': 4}, {'tx': 5, 'success': 1, 'collisions': 4}, {'tx': 9, 'success': 2, 'collisions': 7}, {'tx': 4, 'success': 0, 'collisions': 4}, {'tx': 4, 'success': 0, 'collisions': 4}, {'tx': 3, 'success': 0, 'collisions': 3}, {'tx': 8, 'success': 2, 'collisions': 6}, {'tx': 4, 'success': 0, 'collisions': 4}, {'tx': 12, 'success': 4, 'collisions': 8}, {'tx': 3, 'success': 0, 'collisions': 3}, {'tx': 4, 'success': 0, 'collisions': 4}, {'tx': 3, 'success': 0, 'collisions': 3}, {'tx': 8, 'success': 2, 'collisions': 6}, {'tx': 9, 'success': 4, 'collisions': 5}, {'tx': 4, 'success': 0, 'collisions': 4}, {'tx': 5, 'success': 1, 'collisions': 4}, {'tx': 4, 'success': 0, 'collisions': 4}, {'tx': 10, 'success': 2, 'collisions': 8}, {'tx': 4, 'success': 0, 'collisions': 4}, {'tx': 3, 'success': 0, 'collisions': 3}, {'tx': 6, 'success': 1, 'collisions': 5}, {'tx': 4, 'success': 0, 'collisions': 4}, {'tx': 4, 'success': 0, 'collisions': 4}, {'tx': 7, 'success': 3, 'collisions': 4}, {'tx': 3, 'success': 0, 'collisions': 3}, {'tx': 8, 'success': 2, 'collisions': 6}, {'tx': 3, 'success': 0, 'collisions': 3}, {'tx': 7, 'success': 4, 'collisions': 3}, {'tx': 4, 'success': 0, 'collisions': 4}, {'tx': 4, 'success': 0, 'collisions': 4}, {'tx': 13, 'success': 6, 'collisions': 7}, {'tx': 4, 'success': 0, 'collisions': 4}, {'tx': 3, 'success': 0, 'collisions': 3}, {'tx': 4, 'success': 0, 'collisions': 4}, {'tx': 4, 'success': 0, 'collisions': 4}, {'tx': 4, 'success': 0, 'collisions': 4}]"
292,40,93,215,48,167,0.7767441860465116,0.22325581395348837,0.4464,"[{'tx': 4, 'success': 0, 'collisions': 4}, {'tx': 6, 'success': 3, 'collisions': 3}, {'tx': 9, 'success': 3, 'collisions': 6}, {'tx': 3, 'success': 0, 'collisions': 3}, {'tx': 4, 'success': 0, 'collisions': 4}, {'tx': 4, 'success': 0, 'collisions': 4}, {'tx': 3, 'success': 0, 'collisions': 3}, {'tx': 4, 'success': 0, 'collisions': 4}, {'tx': 3, 'success': 0, 'collisions': 3}, {'tx': 11, 'success': 3, 'collisions': 8}, {'tx': 8, 'success': 3, 'collisions': 5}, {'tx': 3, 'success': 0, 'collisions': 3}, {'tx': 3, 'success': 0, 'collisions': 3}, {'tx': 5, 'success': 1, 'collisions': 4}, {'tx': 11, 'success': 5, 'collisions': 6}, {'tx': 6, 'success': 1, 'collisions': 5}, {'tx': 4, 'success': 0, 'collisions': 4}, {'tx': 3, 'success': 0, 'collisions': 3}, {'tx': 4, 'success': 0, 'collisions': 4}, {'tx': 7, 'success': 3, 'collisions': 4}, {'tx': 3, 'success': 0, 'collisions': 3}, {'tx': 5, 'success': 1, 'collisions': 4}, {'tx': 3, 'success': 0, 'collisions': 3}, {'tx': 5, 'success': 1, 'collisions': 4}, {'tx': 5, 'success': 2, 'collisions': 3}, {'tx': 5, 'success': 1, 'collisions': 4}, {'tx': 11, 'success': 3, 'collisions': 8}, {'tx': 4, 'success': 0, 'collisions': 4}, {'tx': 4, 'success': 0, 'collisions': 4}, {'tx': 10, 'success': 5, 'collisions': 5}, {'tx': 4, 'success': 0, 'collisions': 4}, {'tx': 3, 'success': 0, 'collisions': 3}, {'tx': 4, 'success': 0, 'collisions': 4}, {'tx': 4, 'success': 0, 'collisions': 4}, {'tx': 6, 'success': 1, 'collisions': 5}, {'tx': 9, 'success': 3, 'collisions': 6}, {'tx': 5, 'success': 1, 'collisions': 4}, {'tx': 8, 'success': 4, 'collisions': 4}, {'tx': 3, 'success': 0, 'collisions': 3}, {'tx': 9, 'success': 4, 'collisions': 5}]"
293,40,94,217,46,171,0.7880184331797235,0.2119815668202765,0.4324,"[{'tx': 6, 'success': 2, 'collisions': 4}, {'tx': 4, 'success': 0, 'collisions': 4}, {'tx': 6, 'success': 0, 'collisions': 6}, {'tx': 4, 'success': 0, 'collisions': 4}, {'tx': 8, 'success': 4, 'collisions': 4}, {'tx': 4, 'success': 0, 'collisions': 4}, {'tx': 5, 'success': 1, 'collisions': 4}, {'tx': 3, 'success': 0, 'collisions': 3}, {'tx': 6, 'success': 2, 'collisions': 4}, {'tx': 6, 'success': 2, 'collisions': 4}, {'tx': 9, 'success': 5, 'collisions': 4}, {'tx': 13, 'success': 5, 'collisions': 8}, {'tx': 4, 'success': 0, 'collisions': 4}, {'tx': 5, 'success': 1, 'collisions': 4}, {'tx': 4, 'success': 0, 'collisions': 4}, {'tx': 7, 'success': 2, 'collisions': 5}, {'tx': 3, 'success': 0, 'collisions': 3}, {'tx': 5, 'success': 1, 'collisions': 4}, {'tx': 3, 'success': 0, 'collisions': 3}, {'tx': 5, 'success': 0, 'collisions': 5}, {'tx': 9, 'success': 3, 'collisions': 6}, {'tx': 4, 'success': 0, 'collisions': 4}, {'tx': 7, 'success': 2, 'collisions': 5}, {'tx': 3, 'success': 0, 'collisions': 3}, {'tx': 4, 'success': 1, 'collisions': 3}, {'tx': 3, 'success': 0, 'collisions': 3}, {'tx': 3, 'success': 0, 'collisions': 3}, {'tx': 6, 'success': 2, 'collisions': 4}, {'tx': 7, 'success': 2, 'collisions': 5}, {'tx': 4, 'success': 0, 'collisions': 4}, {'tx': 4, 'success': 0, 'collisions': 4}, {'tx': 6, 'success': 1, 'collisions': 5}, {'tx': 4, 'success': 0, 'collisions': 4}, {'tx': 8, 'success': 2, 'collisions': 6}, {'tx': 4, 'success': 0, 'collisions': 4}, {'tx': 10, 'success': 4, 'collisions': 6}, {'tx': 5, 'success': 1, 'collisions': 4}, {'tx': 4, 'success': 0, 'collisions': 4}, {'tx': 9, 'success': 3, 'collisions': 6}, {'tx': 3, 'success': 0, 'collisions': 3}]"
294,40,95,217,44,173,0.7972350230414746,0.20276497695852536,0.418,"[{'tx': 7, 'success': 2, 'collisions': 5}, {'tx': 4, 'success': 0, 'collisions': 4}, {'tx': 5, 'success': 1, 'collisions': 4}, {'tx': 6, 'success': 2, 'collisions': 4}, {'tx': 4, 'success': 0, 'collisions': 4}, {'tx': 4, 'success': 0, 'collisions': 4}, {'tx': 8, 'success': 2, 'collisions': 6}, {'tx': 3, 'success': 0, 'collisions': 3}, {'tx': 6, 'success': 1, 'collisions': 5}, {'tx': 4, 'success': 0, 'collisions': 4}, {'tx': 6, 'success': 1, 'collisions': 5}, {'tx': 5, 'success': 1, 'collisions': 4}, {'tx': 6, 'success': 1, 'collisions': 5}, {'tx': 6, 'success': 1, 'collisions': 5}, {'tx': 3, 'success': 0, 'collisions': 3}, {'tx': 8, 'success': 4, 'collisions': 4}, {'tx': 6, 'success': 1, 'collisions': 5}, {'tx': 6, 'success': 1, 'collisions': 5}, {'tx': 5, 'success': 0, 'collisions': 5}, {'tx': 3, 'success': 0, 'collisions': 3}, {'tx': 5, 'success': 1, 'collisions': 4}, {'tx': 7, 'success': 3, 'collisions': 4}, {'tx': 6, 'success': 2, 'collisions': 4}, {'tx': 9, 'success': 3, 'collisions': 6}, {'tx': 7, 'success': 1, 'collisions': 6}, {'tx': 4, 'success': 0, 'collisions': 4}, {'tx': 9, 'success': 4, 'collisions': 5}, {'tx': 6, 'success': 1, 'collisions': 5}, {'tx': 4, 'success': 1, 'collisions': 3}, {'tx': 5, 'success': 1, 'collisions': 4}, {'tx': 11, 'success': 4, 'collisions': 7}, {'tx': 4, 'success': 0, 'collisions': 4}, {'tx': 8, 'success': 2, 'collisions': 6}, {'tx': 4, 'success': 0, 'collisions': 4}, {'tx': 6, 'success': 1, 'collisions': 5}, {'tx': 3, 'success': 0, 'collisions': 3}, {'tx': 3, 'success': 0, 'collisions': 3}, {'tx': 3, 'success': 0, 'collisions': 3}, {'tx': 5, 'success': 2, 'collisions': 3}, {'tx': 3, 'success': 0, 'collisions': 3}]"
295,40,96,210,47,163,0.7761904761904762,0.22380952380952382,0.4512,"[{'tx': 6, 'success': 2, 'collisions': 4}, {'tx': 3, 'success': 0, 'collisions': 3}, {'tx': 5, 'success': 1, 'collisions': 4}, {'tx': 6, 'success': 1, 'collisions': 5}, {'tx': 6, 'success': 1, 'collisions': 5}, {'tx': 5, 'success': 1, 'collisions': 4}, {'tx': 4, 'success': 0, 'collisions': 4}, {'tx': 7, 'success': 2, 'collisions': 5}, {'tx': 7, 'success': 2, 'collisions': 5}, {'tx': 6, 'success': 2, 'collisions': 4}, {'tx': 4, 'success': 0, 'collisions': 4}, {'tx': 10, 'success': 5, 'collisions': 5}, {'tx': 8, 'success': 2, 'collisions': 6}, {'tx': 3, 'success': 0, 'collisions': 3}, {'tx': 9, 'success': 5, 'collisions': 4}, {'tx': 8, 'success': 3, 'collisions': 5}, {'tx': 4, 'success': 0, 'collisions': 4}, {'tx': 3, 'success': 0, 'collisions': 3}, {'tx': 8, 'success': 3, 'collisions': 5}, {'tx': 8, 'success': 1, 'collisions': 7}, {'tx': 3, 'success': 0, 'collisions': 3}, {'tx': 4, 'success': 1, 'collisions': 3}, {'tx': 3, 'success': 0, 'collisions': 3}, {'tx': 3, 'success': 0, 'collisions': 3}, {'tx': 4, 'success': 0, 'collisions': 4}, {'tx': 9, 'success': 4, 'collisions': 5}, {'tx': 7, 'success': 3, 'collisions': 4}, {'tx': 3, 'success': 0, 'collisions': 3}, {'tx': 4, 'success': 0, 'collisions': 4}, {'tx': 5, 'success': 1, 'collisions': 4}, {'tx': 5, 'success': 1, 'collisions': 4}, {'tx': 4, 'success': 0, 'collisions': 4}, {'tx': 6, 'success': 2, 'collisions': 4}, {'tx': 5, 'success': 1, 'collisions': 4}, {'tx': 3, 'success': 0, 'collisions': 3}, {'tx': 4, 'success': 0, 'collisions': 4}, {'tx': 9, 'success': 3, 'collisions': 6}, {'tx': 3, 'success': 0, 'collisions': 3}, {'tx': 3, 'success': 0, 'collisions': 3}, {'tx': 3, 'success': 0, 'collisions': 3}]"
296,40,97,219,39,180,0.821917808219178,0.1780821917808219,0.3783,"[{'tx': 6, 'success': 1, 'collisions': 5}, {'tx': 8, 'success': 2, 'collisions': 6}, {'tx': 3, 'success': 0, 'collisions': 3}, {'tx': 4, 'success': 0, 'collisions': 4}, {'tx': 10, 'success': 4, 'collisions': 6}, {'tx': 4, 'success': 0, 'collisions': 4}, {'tx': 8, 'success': 3, 'collisions': 5}, {'tx': 9, 'success': 4, 'collisions': 5}, {'tx': 4, 'success': 0, 'collisions': 4}, {'tx': 4, 'success': 0, 'collisions': 4}, {'tx': 4, 'success': 0, 'collisions': 4}, {'tx': 6, 'success': 1, 'collisions': 5}, {'tx': 6, 'success': 1, 'collisions': 5}, {'tx': 8, 'success': 2, 'collisions': 6}, {'tx': 4, 'success': 0, 'collisions': 4}, {'tx': 6, 'success': 1, 'collisions': 5}, {'tx': 4, 'success': 0, 'collisions': 4}, {'tx': 4, 'success': 0, 'collisions': 4}, {'tx': 3, 'success': 0, 'collisions': 3}, {'tx': 4, 'success': 0, 'collisions': 4}, {'tx': 4, 'success': 0, 'collisions': 4}, {'tx': 5, 'success': 1, 'collisions': 4}, {'tx': 4, 'success': 0, 'collisions': 4}, {'tx': 4, 'success': 0, 'collisions': 4}, {'tx': 3, 'success': 0, 'collisions': 3}, {'tx': 4, 'success': 0, 'collisions': 4}, {'tx': 3, 'success': 0, 'collisions': 3}, {'tx': 4, 'success': 0, 'collisions': 4}, {'tx': 4, 'success': 1, 'collisions': 3}, {'tx': 5, 'success': 0, 'collisions': 5}, {'tx': 4, 'success': 0, 'collisions': 4}, {'tx': 6, 'success': 1, 'collisions': 5}, {'tx': 3, 'success': 0, 'collisions': 3}, {'tx': 10, 'success': 4, 'collisions': 6}, {'tx': 11, 'success': 5, 'collisions': 6}, {'tx': 13, 'success': 4, 'collisions': 9}, {'tx': 6, 'success': 1, 'collisions': 5}, {'tx': 5, 'success': 1, 'collisions': 4}, {'tx': 4, 'success': 0, 'collisions': 4}, {'tx': 8, 'success': 2, 'collisions': 6}]"
297,40,98,214,45,169,0.7897196261682243,0.2102803738317757,0.441,"[{'tx': 3, 'success': 0, 'collisions': 3}, {'tx': 11, 'success': 6, 'collisions': 5}, {'tx': 3, 'success': 0, 'collisions': 3}, {'tx': 9, 'success': 3, 'collisions': 6}, {'tx': 5, 'success': 1, 'collisions': 4}, {'tx': 4, 'success': 0, 'collisions': 4}, {'tx': 3, 'success': 0, 'collisions': 3}, {'tx': 7, 'success': 2, 'collisions': 5}, {'tx': 4, 'success': 0, 'collisions': 4}, {'tx': 4, 'success': 1, 'collisions': 3}, {'tx': 6, 'success': 1, 'collisions': 5}, {'tx': 8, 'success': 3, 'collisions': 5}, {'tx': 7, 'success': 1, 'collisions': 6}, {'tx': 5, 'success': 1, 'collisions': 4}, {'tx': 11, 'success': 4, 'collisions': 7}, {'tx': 4, 'success': 0, 'collisions': 4}, {'tx': 5, 'success': 0, 'collisions': 5}, {'tx': 4, 'success': 0, 'collisions': 4}, {'tx': 4, 'success': 1, 'collisions': 3}, {'tx': 3, 'success': 0, 'collisions': 3}, {'tx': 8, 'success': 4, 'collisions': 4}, {'tx': 11, 'success': 5, 'collisions': 6}, {'tx': 4, 'success': 0, 'collisions': 4}, {'tx': 4, 'success': 0, 'collisions': 4}, {'tx': 8, 'success': 2, 'collisions': 6}, {'tx': 6, 'success': 1, 'collisions': 5}, {'tx': 7, 'success': 2, 'collisions': 5}, {'tx': 5, 'success': 1, 'collisions': 4}, {'tx': 7, 'success': 1, 'collisions': 6}, {'tx': 3, 'success': 0, 'collisions': 3}, {'tx': 3, 'success': 0, 'collisions': 3}, {'tx': 3, 'success': 0, 'collisions': 3}, {'tx': 3, 'success': 0, 'collisions': 3}, {'tx': 6, 'success': 2, 'collisions': 4}, {'tx': 5, 'success': 1, 'collisions': 4}, {'tx': 5, 'success': 1, 'collisions': 4}, {'tx': 4, 'success': 0, 'collisions': 4}, {'tx': 4, 'success': 0, 'collisions': 4}, {'tx': 3, 'success': 0, 'collisions': 3}, {'tx': 5, 'success': 1, 'collisions': 4}]"
298,40,99,204,42,162,0.7941176470588235,0.20588235294117646,0.4158,"[{'tx': 4, 'success': 1, 'collisions': 3}, {'tx': 6, 'success': 1, 'collisions': 5}, {'tx': 4, 'success': 0, 'collisions': 4}, {'tx': 4, 'success': 1, 'collisions': 3}, {'tx': 7, 'success': 1, 'collisions': 6}, {'tx': 8, 'success': 3, 'collisions': 5}, {'tx': 3, 'success': 0, 'collisions': 3}, {'tx': 3, 'success': 0, 'collisions': 3}, {'tx': 9, 'success': 5, 'collisions': 4}, {'tx': 4, 'success': 0, 'collisions': 4}, {'tx': 5, 'success': 1, 'collisions': 4}, {'tx': 4, 'success': 0, 'collisions': 4}, {'tx': 3, 'success': 0, 'collisions': 3}, {'tx': 7, 'success': 2, 'collisions': 5}, {'tx': 4, 'success': 0, 'collisions': 4}, {'tx': 3, 'success': 0, 'collisions': 3}, {'tx': 4, 'success': 0, 'collisions': 4}, {'tx': 8, 'success': 3, 'collisions': 5}, {'tx': 5, 'success': 1, 'collisions': 4}, {'tx': 4, 'success': 1, 'collisions': 3}, {'tx': 5, 'success': 1, 'collisions': 4}, {'tx': 5, 'success': 1, 'collisions': 4}, {'tx': 3, 'success': 0, 'collisions': 3}, {'tx': 4, 'success': 0, 'collisions': 4}, {'tx': 5, 'success': 1, 'collisions': 4}, {'tx': 6, 'success': 1, 'collisions': 5}, {'tx': 4, 'success': 0, 'collisions': 4}, {'tx': 3, 'success': 0, 'collisions': 3}, {'tx': 5, 'success': 0, 'collisions': 5}, {'tx': 7, 'success': 3, 'collisions': 4}, {'tx': 8, 'success': 2, 'collisions': 6}, {'tx': 9, 'success': 3, 'collisions': 6}, {'tx': 4, 'success': 0, 'collisions': 4}, {'tx': 3, 'success': 0, 'collisions': 3}, {'tx': 6, 'success': 2, 'collisions': 4}, {'tx': 6, 'success': 2, 'collisions': 4}, {'tx': 3, 'success': 0, 'collisions': 3}, {'tx': 4, 'success': 0, 'collisions': 4}, {'tx': 6, 'success': 1, 'collisions': 5}, {'tx': 9, 'success': 5, 'collisions': 4}]"
299,40,100,203,40,163,0.8029556650246306,0.19704433497536947,0.4,"[{'tx': 8, 'success': 2, 'collisions': 6}, {'tx': 6, 'success': 1, 'collisions': 5}, {'tx': 4, 'success': 0, 'collisions': 4}, {'tx': 3, 'success': 0, 'collisions': 3}, {'tx': 7, 'success': 2, 'collisions': 5}, {'tx': 6, 'success': 1, 'collisions': 5}, {'tx': 4, 'success': 0, 'collisions': 4}, {'tx': 8, 'success': 4, 'collisions': 4}, {'tx': 7, 'success': 3, 'collisions': 4}, {'tx': 6, 'success': 2, 'collisions': 4}, {'tx': 5, 'success': 1, 'collisions': 4}, {'tx': 11, 'success': 5, 'collisions': 6}, {'tx': 4, 'success': 0, 'collisions': 4}, {'tx': 3, 'success': 0, 'collisions': 3}, {'tx': 3, 'success': 0, 'collisions': 3}, {'tx': 3, 'success': 0, 'collisions': 3}, {'tx': 3, 'success': 0, 'collisions': 3}, {'tx': 7, 'success': 2, 'collisions': 5}, {'tx': 4, 'success': 0, 'collisions': 4}, {'tx': 3, 'success': 0, 'collisions': 3}, {'tx': 4, 'success': 0, 'collisions': 4}, {'tx': 4, 'success': 1, 'collisions': 3}, {'tx': 4, 'success': 0, 'collisions': 4}, {'tx': 4, 'success': 0, 'collisions': 4}, {'tx': 10, 'success': 5, 'collisions': 5}, {'tx': 4, 'success': 0, 'collisions': 4}, {'tx': 3, 'success': 0, 'collisions': 3}, {'tx': 7, 'success': 3, 'collisions': 4}, {'tx': 4, 'success': 0, 'collisions': 4}, {'tx': 4, 'success': 0, 'collisions': 4}, {'tx': 3, 'success': 0, 'collisions': 3}, {'tx': 4, 'success': 1, 'collisions': 3}, {'tx': 6, 'success': 1, 'collisions': 5}, {'tx': 6, 'success': 1, 'collisions': 5}, {'tx': 7, 'success': 2, 'collisions': 5}, {'tx': 7, 'success': 2, 'collisions': 5}, {'tx': 4, 'success': 0, 'collisions': 4}, {'tx': 4, 'success': 0, 'collisions': 4}, {'tx': 5, 'success': 1, 'collisions': 4}, {'tx': 4, 'success': 0, 'collisions': 4}]"
